"Year";"id";"lat";"long";"Start";"End";"Duration"
1844;49;55,8363491;12,1205977;1844;1849;5
1844;296;55,369252;9,052748;1844;1885;41
1845;49;55,8363491;12,1205977;1844;1849;5
1845;173;55,406473;9,968562;1845;1848;3
1845;296;55,369252;9,052748;1844;1885;41
1846;49;55,8363491;12,1205977;1844;1849;5
1846;173;55,406473;9,968562;1845;1848;3
1846;296;55,369252;9,052748;1844;1885;41
1847;49;55,8363491;12,1205977;1844;1849;5
1847;173;55,406473;9,968562;1845;1848;3
1847;296;55,369252;9,052748;1844;1885;41
1847;22;55,76746;12,19748;1847;1848;1
1848;49;55,8363491;12,1205977;1844;1849;5
1848;73;55,84433;9,589121;1848;2021;173
1848;173;55,406473;9,968562;1845;1848;3
1848;296;55,369252;9,052748;1844;1885;41
1848;22;55,76746;12,19748;1847;1848;1
1849;49;55,8363491;12,1205977;1844;1849;5
1849;73;55,84433;9,589121;1848;2021;173
1849;296;55,369252;9,052748;1844;1885;41
1850;73;55,84433;9,589121;1848;2021;173
1850;296;55,369252;9,052748;1844;1885;41
1851;53;55,248382;10,529702;1851;1853;2
1851;73;55,84433;9,589121;1848;2021;173
1851;296;55,369252;9,052748;1844;1885;41
1851;20;57,269878;9,94053;1851;1854;3
1851;240;56,66165;8,85992;1851;1855;4
1852;53;55,248382;10,529702;1851;1853;2
1852;73;55,84433;9,589121;1848;2021;173
1852;198;55,973781;10,234657;1852;1876;24
1852;296;55,369252;9,052748;1844;1885;41
1852;20;57,269878;9,94053;1851;1854;3
1852;192;55,28643;11,55841;1852;1916;64
1852;240;56,66165;8,85992;1851;1855;4
1853;53;55,248382;10,529702;1851;1853;2
1853;73;55,84433;9,589121;1848;2021;173
1853;109;55,81918;9,872189;1853;1870;17
1853;132;55,514899;10,66225;1853;1862;9
1853;198;55,973781;10,234657;1852;1876;24
1853;296;55,369252;9,052748;1844;1885;41
1853;20;57,269878;9,94053;1851;1854;3
1853;103;56,27039;8,28711;1853;1894;41
1853;192;55,28643;11,55841;1852;1916;64
1853;240;56,66165;8,85992;1851;1855;4
1854;73;55,84433;9,589121;1848;2021;173
1854;106;55,934809;9,843892;1854;1881;27
1854;109;55,81918;9,872189;1853;1870;17
1854;132;55,514899;10,66225;1853;1862;9
1854;198;55,973781;10,234657;1852;1876;24
1854;296;55,369252;9,052748;1844;1885;41
1854;20;57,269878;9,94053;1851;1854;3
1854;103;56,27039;8,28711;1853;1894;41
1854;192;55,28643;11,55841;1852;1916;64
1854;240;56,66165;8,85992;1851;1855;4
1855;73;55,84433;9,589121;1848;2021;173
1855;92;57,397496;9,892683;1855;1882;27
1855;106;55,934809;9,843892;1854;1881;27
1855;109;55,81918;9,872189;1853;1870;17
1855;132;55,514899;10,66225;1853;1862;9
1855;198;55,973781;10,234657;1852;1876;24
1855;241;56,651494;8,934794;1855;1908;53
1855;296;55,369252;9,052748;1844;1885;41
1855;103;56,27039;8,28711;1853;1894;41
1855;192;55,28643;11,55841;1852;1916;64
1855;240;56,66165;8,85992;1851;1855;4
1856;12;55,0702424;14,9213634;1856;1858;2
1856;73;55,84433;9,589121;1848;2021;173
1856;92;57,397496;9,892683;1855;1882;27
1856;106;55,934809;9,843892;1854;1881;27
1856;109;55,81918;9,872189;1853;1870;17
1856;132;55,514899;10,66225;1853;1862;9
1856;143;55,707689;12,555774;1856;1890;34
1856;198;55,973781;10,234657;1852;1876;24
1856;241;56,651494;8,934794;1855;1908;53
1856;296;55,369252;9,052748;1844;1885;41
1856;103;56,27039;8,28711;1853;1894;41
1856;192;55,28643;11,55841;1852;1916;64
1857;12;55,0702424;14,9213634;1856;1858;2
1857;73;55,84433;9,589121;1848;2021;173
1857;92;57,397496;9,892683;1855;1882;27
1857;106;55,934809;9,843892;1854;1881;27
1857;109;55,81918;9,872189;1853;1870;17
1857;132;55,514899;10,66225;1853;1862;9
1857;143;55,707689;12,555774;1856;1890;34
1857;198;55,973781;10,234657;1852;1876;24
1857;241;56,651494;8,934794;1855;1908;53
1857;296;55,369252;9,052748;1844;1885;41
1857;103;56,27039;8,28711;1853;1894;41
1857;192;55,28643;11,55841;1852;1916;64
1857;349;56,12853;10,16653;1857;1899;42
1858;12;55,0702424;14,9213634;1856;1858;2
1858;73;55,84433;9,589121;1848;2021;173
1858;92;57,397496;9,892683;1855;1882;27
1858;106;55,934809;9,843892;1854;1881;27
1858;109;55,81918;9,872189;1853;1870;17
1858;132;55,514899;10,66225;1853;1862;9
1858;143;55,707689;12,555774;1856;1890;34
1858;198;55,973781;10,234657;1852;1876;24
1858;241;56,651494;8,934794;1855;1908;53
1858;296;55,369252;9,052748;1844;1885;41
1858;103;56,27039;8,28711;1853;1894;41
1858;192;55,28643;11,55841;1852;1916;64
1858;349;56,12853;10,16653;1857;1899;42
1859;56;55,252457;10,508458;1859;1864;5
1859;73;55,84433;9,589121;1848;2021;173
1859;92;57,397496;9,892683;1855;1882;27
1859;106;55,934809;9,843892;1854;1881;27
1859;109;55,81918;9,872189;1853;1870;17
1859;124;57,2256243;9,6747751;1859;1863;4
1859;132;55,514899;10,66225;1853;1862;9
1859;143;55,707689;12,555774;1856;1890;34
1859;198;55,973781;10,234657;1852;1876;24
1859;241;56,651494;8,934794;1855;1908;53
1859;296;55,369252;9,052748;1844;1885;41
1859;103;56,27039;8,28711;1853;1894;41
1859;192;55,28643;11,55841;1852;1916;64
1859;201;55,45808;10,37744;1859;1893;34
1859;349;56,12853;10,16653;1857;1899;42
1860;56;55,252457;10,508458;1859;1864;5
1860;73;55,84433;9,589121;1848;2021;173
1860;92;57,397496;9,892683;1855;1882;27
1860;106;55,934809;9,843892;1854;1881;27
1860;109;55,81918;9,872189;1853;1870;17
1860;124;57,2256243;9,6747751;1859;1863;4
1860;132;55,514899;10,66225;1853;1862;9
1860;143;55,707689;12,555774;1856;1890;34
1860;198;55,973781;10,234657;1852;1876;24
1860;241;56,651494;8,934794;1855;1908;53
1860;269;56,409039;10,566345;1860;1865;5
1860;296;55,369252;9,052748;1844;1885;41
1860;103;56,27039;8,28711;1853;1894;41
1860;192;55,28643;11,55841;1852;1916;64
1860;201;55,45808;10,37744;1859;1893;34
1860;211;56,58663;10,12878;1860;1877;17
1860;349;56,12853;10,16653;1857;1899;42
1861;56;55,252457;10,508458;1859;1864;5
1861;73;55,84433;9,589121;1848;2021;173
1861;92;57,397496;9,892683;1855;1882;27
1861;106;55,934809;9,843892;1854;1881;27
1861;109;55,81918;9,872189;1853;1870;17
1861;124;57,2256243;9,6747751;1859;1863;4
1861;132;55,514899;10,66225;1853;1862;9
1861;143;55,707689;12,555774;1856;1890;34
1861;198;55,973781;10,234657;1852;1876;24
1861;241;56,651494;8,934794;1855;1908;53
1861;269;56,409039;10,566345;1860;1865;5
1861;296;55,369252;9,052748;1844;1885;41
1861;103;56,27039;8,28711;1853;1894;41
1861;192;55,28643;11,55841;1852;1916;64
1861;201;55,45808;10,37744;1859;1893;34
1861;211;56,58663;10,12878;1860;1877;17
1861;349;56,12853;10,16653;1857;1899;42
1862;56;55,252457;10,508458;1859;1864;5
1862;73;55,84433;9,589121;1848;2021;173
1862;92;57,397496;9,892683;1855;1882;27
1862;106;55,934809;9,843892;1854;1881;27
1862;109;55,81918;9,872189;1853;1870;17
1862;124;57,2256243;9,6747751;1859;1863;4
1862;132;55,514899;10,66225;1853;1862;9
1862;143;55,707689;12,555774;1856;1890;34
1862;198;55,973781;10,234657;1852;1876;24
1862;200;55,365817;10,394151;1862;1886;24
1862;241;56,651494;8,934794;1855;1908;53
1862;269;56,409039;10,566345;1860;1865;5
1862;296;55,369252;9,052748;1844;1885;41
1862;103;56,27039;8,28711;1853;1894;41
1862;192;55,28643;11,55841;1852;1916;64
1862;201;55,45808;10,37744;1859;1893;34
1862;211;56,58663;10,12878;1860;1877;17
1862;349;56,12853;10,16653;1857;1899;42
1863;56;55,252457;10,508458;1859;1864;5
1863;73;55,84433;9,589121;1848;2021;173
1863;92;57,397496;9,892683;1855;1882;27
1863;106;55,934809;9,843892;1854;1881;27
1863;109;55,81918;9,872189;1853;1870;17
1863;124;57,2256243;9,6747751;1859;1863;4
1863;143;55,707689;12,555774;1856;1890;34
1863;198;55,973781;10,234657;1852;1876;24
1863;200;55,365817;10,394151;1862;1886;24
1863;241;56,651494;8,934794;1855;1908;53
1863;269;56,409039;10,566345;1860;1865;5
1863;296;55,369252;9,052748;1844;1885;41
1863;297;55,560374;9,240375;1863;1864;1
1863;103;56,27039;8,28711;1853;1894;41
1863;192;55,28643;11,55841;1852;1916;64
1863;201;55,45808;10,37744;1859;1893;34
1863;211;56,58663;10,12878;1860;1877;17
1863;349;56,12853;10,16653;1857;1899;42
1864;56;55,252457;10,508458;1859;1864;5
1864;73;55,84433;9,589121;1848;2021;173
1864;92;57,397496;9,892683;1855;1882;27
1864;106;55,934809;9,843892;1854;1881;27
1864;109;55,81918;9,872189;1853;1870;17
1864;143;55,707689;12,555774;1856;1890;34
1864;177;56,839448;8,717907;1864;1946;82
1864;198;55,973781;10,234657;1852;1876;24
1864;200;55,365817;10,394151;1862;1886;24
1864;241;56,651494;8,934794;1855;1908;53
1864;269;56,409039;10,566345;1860;1865;5
1864;296;55,369252;9,052748;1844;1885;41
1864;297;55,560374;9,240375;1863;1864;1
1864;71;55,98048;12,02986;1864;1892;28
1864;103;56,27039;8,28711;1853;1894;41
1864;129;55,54022;11,3084;1864;1866;2
1864;192;55,28643;11,55841;1852;1916;64
1864;201;55,45808;10,37744;1859;1893;34
1864;211;56,58663;10,12878;1860;1877;17
1864;349;56,12853;10,16653;1857;1899;42
1865;73;55,84433;9,589121;1848;2021;173
1865;92;57,397496;9,892683;1855;1882;27
1865;106;55,934809;9,843892;1854;1881;27
1865;109;55,81918;9,872189;1853;1870;17
1865;138;55,430432;9,31255;1865;1882;17
1865;143;55,707689;12,555774;1856;1890;34
1865;174;55,484458;9,808862;1865;1866;1
1865;177;56,839448;8,717907;1864;1946;82
1865;198;55,973781;10,234657;1852;1876;24
1865;200;55,365817;10,394151;1862;1886;24
1865;241;56,651494;8,934794;1855;1908;53
1865;269;56,409039;10,566345;1860;1865;5
1865;294;55,471013;9,099652;1865;2021;156
1865;296;55,369252;9,052748;1844;1885;41
1865;71;55,98048;12,02986;1864;1892;28
1865;103;56,27039;8,28711;1853;1894;41
1865;118;55,89164;12,49476;1865;1866;1
1865;129;55,54022;11,3084;1864;1866;2
1865;192;55,28643;11,55841;1852;1916;64
1865;201;55,45808;10,37744;1859;1893;34
1865;208;55,74166;11,41925;1865;2021;156
1865;211;56,58663;10,12878;1860;1877;17
1865;323;54,96729;12,23395;1865;1866;1
1865;349;56,12853;10,16653;1857;1899;42
1866;55;55,242371;10,53961;1866;2021;155
1866;73;55,84433;9,589121;1848;2021;173
1866;75;55,731027;9,833955;1866;1939;73
1866;92;57,397496;9,892683;1855;1882;27
1866;106;55,934809;9,843892;1854;1881;27
1866;109;55,81918;9,872189;1853;1870;17
1866;128;55,512352;11,287189;1866;1930;64
1866;138;55,430432;9,31255;1865;1882;17
1866;143;55,707689;12,555774;1856;1890;34
1866;174;55,484458;9,808862;1865;1866;1
1866;177;56,839448;8,717907;1864;1946;82
1866;198;55,973781;10,234657;1852;1876;24
1866;200;55,365817;10,394151;1862;1886;24
1866;241;56,651494;8,934794;1855;1908;53
1866;294;55,471013;9,099652;1865;2021;156
1866;296;55,369252;9,052748;1844;1885;41
1866;322;54,9748134;12,2737822;1866;2021;155
1866;330;56,92528;10,018117;1866;1908;42
1866;346;56,067076;10,134812;1866;2021;155
1866;71;55,98048;12,02986;1864;1892;28
1866;103;56,27039;8,28711;1853;1894;41
1866;118;55,89164;12,49476;1865;1866;1
1866;129;55,54022;11,3084;1864;1866;2
1866;192;55,28643;11,55841;1852;1916;64
1866;201;55,45808;10,37744;1859;1893;34
1866;208;55,74166;11,41925;1865;2021;156
1866;211;56,58663;10,12878;1860;1877;17
1866;323;54,96729;12,23395;1865;1866;1
1866;349;56,12853;10,16653;1857;1899;42
1866;350;56,08331;10,14002;1866;1870;4
1867;55;55,242371;10,53961;1866;2021;155
1867;61;55,5970491;12,2066402;1867;1871;4
1867;73;55,84433;9,589121;1848;2021;173
1867;75;55,731027;9,833955;1866;1939;73
1867;81;56,133911;9,056668;1867;1884;17
1867;86;55,902118;12,238497;1867;1880;13
1867;92;57,397496;9,892683;1855;1882;27
1867;106;55,934809;9,843892;1854;1881;27
1867;109;55,81918;9,872189;1853;1870;17
1867;128;55,512352;11,287189;1866;1930;64
1867;138;55,430432;9,31255;1865;1882;17
1867;141;55,6869;12,558947;1867;1872;5
1867;143;55,707689;12,555774;1856;1890;34
1867;151;54,861238;10,73061;1867;1978;111
1867;177;56,839448;8,717907;1864;1946;82
1867;198;55,973781;10,234657;1852;1876;24
1867;200;55,365817;10,394151;1862;1886;24
1867;241;56,651494;8,934794;1855;1908;53
1867;260;55,110103;10,734595;1867;1930;63
1867;266;56,285209;10,585515;1867;1870;3
1867;294;55,471013;9,099652;1865;2021;156
1867;296;55,369252;9,052748;1844;1885;41
1867;308;55,671645;9,5777;1867;1939;72
1867;322;54,9748134;12,2737822;1866;2021;155
1867;330;56,92528;10,018117;1866;1908;42
1867;344;56,221813;10,166272;1867;1869;2
1867;346;56,067076;10,134812;1866;2021;155
1867;13;55,18902;14,96054;1867;2021;154
1867;71;55,98048;12,02986;1864;1892;28
1867;76;55,88792;9,56415;1867;1869;2
1867;103;56,27039;8,28711;1853;1894;41
1867;108;55,89553;9,71437;1867;1877;10
1867;157;54,83432;11,32731;1867;1887;20
1867;179;56,4335;10,37541;1867;1870;3
1867;191;55,1839;11,98427;1867;1947;80
1867;192;55,28643;11,55841;1852;1916;64
1867;201;55,45808;10,37744;1859;1893;34
1867;208;55,74166;11,41925;1865;2021;156
1867;211;56,58663;10,12878;1860;1877;17
1867;233;56,27723;9,36086;1867;1870;3
1867;349;56,12853;10,16653;1857;1899;42
1867;350;56,08331;10,14002;1866;1870;4
1868;8;55,379535;10,047905;1868;1874;6
1868;15;57,2642721;9,9501182;1868;1904;36
1868;48;55,747728;11,957286;1868;1871;3
1868;55;55,242371;10,53961;1866;2021;155
1868;61;55,5970491;12,2066402;1867;1871;4
1868;73;55,84433;9,589121;1848;2021;173
1868;75;55,731027;9,833955;1866;1939;73
1868;81;56,133911;9,056668;1867;1884;17
1868;86;55,902118;12,238497;1867;1880;13
1868;92;57,397496;9,892683;1855;1882;27
1868;106;55,934809;9,843892;1854;1881;27
1868;109;55,81918;9,872189;1853;1870;17
1868;128;55,512352;11,287189;1866;1930;64
1868;138;55,430432;9,31255;1865;1882;17
1868;141;55,6869;12,558947;1867;1872;5
1868;143;55,707689;12,555774;1856;1890;34
1868;151;54,861238;10,73061;1867;1978;111
1868;177;56,839448;8,717907;1864;1946;82
1868;182;56,453059;10,866897;1868;1938;70
1868;198;55,973781;10,234657;1852;1876;24
1868;200;55,365817;10,394151;1862;1886;24
1868;231;56,207889;9,466901;1868;1889;21
1868;241;56,651494;8,934794;1855;1908;53
1868;260;55,110103;10,734595;1867;1930;63
1868;266;56,285209;10,585515;1867;1870;3
1868;280;56,79505;8,36757;1868;1877;9
1868;281;55,195436;8,725969;1868;1870;2
1868;293;55,809434;8,632002;1868;1881;13
1868;294;55,471013;9,099652;1865;2021;156
1868;296;55,369252;9,052748;1844;1885;41
1868;305;55,810619;9,428677;1868;1873;5
1868;308;55,671645;9,5777;1867;1939;72
1868;315;56,552152;9,40118;1868;2021;153
1868;322;54,9748134;12,2737822;1866;2021;155
1868;330;56,92528;10,018117;1866;1908;42
1868;344;56,221813;10,166272;1867;1869;2
1868;346;56,067076;10,134812;1866;2021;155
1868;13;55,18902;14,96054;1867;2021;154
1868;32;56,20715;9,80963;1868;1877;9
1868;71;55,98048;12,02986;1864;1892;28
1868;76;55,88792;9,56415;1867;1869;2
1868;103;56,27039;8,28711;1853;1894;41
1868;108;55,89553;9,71437;1867;1877;10
1868;157;54,83432;11,32731;1867;1887;20
1868;179;56,4335;10,37541;1867;1870;3
1868;184;56,34751;10,8634;1868;1870;2
1868;191;55,1839;11,98427;1867;1947;80
1868;192;55,28643;11,55841;1852;1916;64
1868;201;55,45808;10,37744;1859;1893;34
1868;208;55,74166;11,41925;1865;2021;156
1868;211;56,58663;10,12878;1860;1877;17
1868;233;56,27723;9,36086;1867;1870;3
1868;235;56,14912;9,91448;1868;1939;71
1868;261;55,07418;10,458;1868;1882;14
1868;338;56,21725;10,26629;1868;1870;2
1868;349;56,12853;10,16653;1857;1899;42
1868;350;56,08331;10,14002;1866;1870;4
1869;8;55,379535;10,047905;1868;1874;6
1869;15;57,2642721;9,9501182;1868;1904;36
1869;36;55,306751;12,199669;1869;1924;55
1869;48;55,747728;11,957286;1868;1871;3
1869;55;55,242371;10,53961;1866;2021;155
1869;61;55,5970491;12,2066402;1867;1871;4
1869;70;55,299963;9,620241;1869;1890;21
1869;73;55,84433;9,589121;1848;2021;173
1869;75;55,731027;9,833955;1866;1939;73
1869;81;56,133911;9,056668;1867;1884;17
1869;86;55,902118;12,238497;1867;1880;13
1869;92;57,397496;9,892683;1855;1882;27
1869;106;55,934809;9,843892;1854;1881;27
1869;109;55,81918;9,872189;1853;1870;17
1869;128;55,512352;11,287189;1866;1930;64
1869;138;55,430432;9,31255;1865;1882;17
1869;141;55,6869;12,558947;1867;1872;5
1869;143;55,707689;12,555774;1856;1890;34
1869;151;54,861238;10,73061;1867;1978;111
1869;177;56,839448;8,717907;1864;1946;82
1869;182;56,453059;10,866897;1868;1938;70
1869;198;55,973781;10,234657;1852;1876;24
1869;200;55,365817;10,394151;1862;1886;24
1869;231;56,207889;9,466901;1868;1889;21
1869;241;56,651494;8,934794;1855;1908;53
1869;260;55,110103;10,734595;1867;1930;63
1869;266;56,285209;10,585515;1867;1870;3
1869;268;56,327852;10,394815;1869;1919;50
1869;274;54,950002;9,749616;1869;1874;5
1869;280;56,79505;8,36757;1868;1877;9
1869;281;55,195436;8,725969;1868;1870;2
1869;293;55,809434;8,632002;1868;1881;13
1869;294;55,471013;9,099652;1865;2021;156
1869;295;55,499295;9,034897;1869;1874;5
1869;296;55,369252;9,052748;1844;1885;41
1869;305;55,810619;9,428677;1868;1873;5
1869;306;55,653994;9,302369;1869;1891;22
1869;308;55,671645;9,5777;1867;1939;72
1869;315;56,552152;9,40118;1868;2021;153
1869;322;54,9748134;12,2737822;1866;2021;155
1869;330;56,92528;10,018117;1866;1908;42
1869;336;56,032176;10,125522;1869;2005;136
1869;344;56,221813;10,166272;1867;1869;2
1869;346;56,067076;10,134812;1866;2021;155
1869;13;55,18902;14,96054;1867;2021;154
1869;30;56,27228;10,05575;1869;1872;3
1869;32;56,20715;9,80963;1868;1877;9
1869;71;55,98048;12,02986;1864;1892;28
1869;76;55,88792;9,56415;1867;1869;2
1869;103;56,27039;8,28711;1853;1894;41
1869;108;55,89553;9,71437;1867;1877;10
1869;157;54,83432;11,32731;1867;1887;20
1869;179;56,4335;10,37541;1867;1870;3
1869;184;56,34751;10,8634;1868;1870;2
1869;191;55,1839;11,98427;1867;1947;80
1869;192;55,28643;11,55841;1852;1916;64
1869;201;55,45808;10,37744;1859;1893;34
1869;208;55,74166;11,41925;1865;2021;156
1869;211;56,58663;10,12878;1860;1877;17
1869;233;56,27723;9,36086;1867;1870;3
1869;235;56,14912;9,91448;1868;1939;71
1869;261;55,07418;10,458;1868;1882;14
1869;290;55,62305;8,36912;1869;1918;49
1869;338;56,21725;10,26629;1868;1870;2
1869;349;56,12853;10,16653;1857;1899;42
1869;350;56,08331;10,14002;1866;1870;4
1870;8;55,379535;10,047905;1868;1874;6
1870;15;57,2642721;9,9501182;1868;1904;36
1870;36;55,306751;12,199669;1869;1924;55
1870;48;55,747728;11,957286;1868;1871;3
1870;55;55,242371;10,53961;1866;2021;155
1870;61;55,5970491;12,2066402;1867;1871;4
1870;70;55,299963;9,620241;1869;1890;21
1870;73;55,84433;9,589121;1848;2021;173
1870;75;55,731027;9,833955;1866;1939;73
1870;81;56,133911;9,056668;1867;1884;17
1870;86;55,902118;12,238497;1867;1880;13
1870;92;57,397496;9,892683;1855;1882;27
1870;106;55,934809;9,843892;1854;1881;27
1870;109;55,81918;9,872189;1853;1870;17
1870;128;55,512352;11,287189;1866;1930;64
1870;138;55,430432;9,31255;1865;1882;17
1870;141;55,6869;12,558947;1867;1872;5
1870;143;55,707689;12,555774;1856;1890;34
1870;151;54,861238;10,73061;1867;1978;111
1870;166;56,76116;10,187328;1870;1887;17
1870;177;56,839448;8,717907;1864;1946;82
1870;182;56,453059;10,866897;1868;1938;70
1870;198;55,973781;10,234657;1852;1876;24
1870;200;55,365817;10,394151;1862;1886;24
1870;231;56,207889;9,466901;1868;1889;21
1870;241;56,651494;8,934794;1855;1908;53
1870;260;55,110103;10,734595;1867;1930;63
1870;266;56,285209;10,585515;1867;1870;3
1870;268;56,327852;10,394815;1869;1919;50
1870;274;54,950002;9,749616;1869;1874;5
1870;280;56,79505;8,36757;1868;1877;9
1870;281;55,195436;8,725969;1868;1870;2
1870;293;55,809434;8,632002;1868;1881;13
1870;294;55,471013;9,099652;1865;2021;156
1870;295;55,499295;9,034897;1869;1874;5
1870;296;55,369252;9,052748;1844;1885;41
1870;305;55,810619;9,428677;1868;1873;5
1870;306;55,653994;9,302369;1869;1891;22
1870;308;55,671645;9,5777;1867;1939;72
1870;315;56,552152;9,40118;1868;2021;153
1870;322;54,9748134;12,2737822;1866;2021;155
1870;330;56,92528;10,018117;1866;1908;42
1870;336;56,032176;10,125522;1869;2005;136
1870;346;56,067076;10,134812;1866;2021;155
1870;13;55,18902;14,96054;1867;2021;154
1870;30;56,27228;10,05575;1869;1872;3
1870;32;56,20715;9,80963;1868;1877;9
1870;71;55,98048;12,02986;1864;1892;28
1870;103;56,27039;8,28711;1853;1894;41
1870;108;55,89553;9,71437;1867;1877;10
1870;157;54,83432;11,32731;1867;1887;20
1870;179;56,4335;10,37541;1867;1870;3
1870;184;56,34751;10,8634;1868;1870;2
1870;191;55,1839;11,98427;1867;1947;80
1870;192;55,28643;11,55841;1852;1916;64
1870;201;55,45808;10,37744;1859;1893;34
1870;208;55,74166;11,41925;1865;2021;156
1870;211;56,58663;10,12878;1860;1877;17
1870;233;56,27723;9,36086;1867;1870;3
1870;235;56,14912;9,91448;1868;1939;71
1870;261;55,07418;10,458;1868;1882;14
1870;290;55,62305;8,36912;1869;1918;49
1870;338;56,21725;10,26629;1868;1870;2
1870;349;56,12853;10,16653;1857;1899;42
1870;350;56,08331;10,14002;1866;1870;4
1871;8;55,379535;10,047905;1868;1874;6
1871;15;57,2642721;9,9501182;1868;1904;36
1871;36;55,306751;12,199669;1869;1924;55
1871;48;55,747728;11,957286;1868;1871;3
1871;55;55,242371;10,53961;1866;2021;155
1871;61;55,5970491;12,2066402;1867;1871;4
1871;70;55,299963;9,620241;1869;1890;21
1871;73;55,84433;9,589121;1848;2021;173
1871;75;55,731027;9,833955;1866;1939;73
1871;81;56,133911;9,056668;1867;1884;17
1871;86;55,902118;12,238497;1867;1880;13
1871;92;57,397496;9,892683;1855;1882;27
1871;106;55,934809;9,843892;1854;1881;27
1871;128;55,512352;11,287189;1866;1930;64
1871;138;55,430432;9,31255;1865;1882;17
1871;141;55,6869;12,558947;1867;1872;5
1871;143;55,707689;12,555774;1856;1890;34
1871;151;54,861238;10,73061;1867;1978;111
1871;161;55,7729977;12,5000579;1871;1874;3
1871;166;56,76116;10,187328;1870;1887;17
1871;177;56,839448;8,717907;1864;1946;82
1871;182;56,453059;10,866897;1868;1938;70
1871;198;55,973781;10,234657;1852;1876;24
1871;200;55,365817;10,394151;1862;1886;24
1871;231;56,207889;9,466901;1868;1889;21
1871;241;56,651494;8,934794;1855;1908;53
1871;260;55,110103;10,734595;1867;1930;63
1871;268;56,327852;10,394815;1869;1919;50
1871;274;54,950002;9,749616;1869;1874;5
1871;280;56,79505;8,36757;1868;1877;9
1871;293;55,809434;8,632002;1868;1881;13
1871;294;55,471013;9,099652;1865;2021;156
1871;295;55,499295;9,034897;1869;1874;5
1871;296;55,369252;9,052748;1844;1885;41
1871;305;55,810619;9,428677;1868;1873;5
1871;306;55,653994;9,302369;1869;1891;22
1871;308;55,671645;9,5777;1867;1939;72
1871;315;56,552152;9,40118;1868;2021;153
1871;322;54,9748134;12,2737822;1866;2021;155
1871;330;56,92528;10,018117;1866;1908;42
1871;336;56,032176;10,125522;1869;2005;136
1871;346;56,067076;10,134812;1866;2021;155
1871;13;55,18902;14,96054;1867;2021;154
1871;30;56,27228;10,05575;1869;1872;3
1871;32;56,20715;9,80963;1868;1877;9
1871;71;55,98048;12,02986;1864;1892;28
1871;103;56,27039;8,28711;1853;1894;41
1871;108;55,89553;9,71437;1867;1877;10
1871;157;54,83432;11,32731;1867;1887;20
1871;191;55,1839;11,98427;1867;1947;80
1871;192;55,28643;11,55841;1852;1916;64
1871;201;55,45808;10,37744;1859;1893;34
1871;208;55,74166;11,41925;1865;2021;156
1871;211;56,58663;10,12878;1860;1877;17
1871;235;56,14912;9,91448;1868;1939;71
1871;261;55,07418;10,458;1868;1882;14
1871;290;55,62305;8,36912;1869;1918;49
1871;349;56,12853;10,16653;1857;1899;42
1872;8;55,379535;10,047905;1868;1874;6
1872;15;57,2642721;9,9501182;1868;1904;36
1872;18;57,320114;9,869439;1872;1890;18
1872;36;55,306751;12,199669;1869;1924;55
1872;55;55,242371;10,53961;1866;2021;155
1872;70;55,299963;9,620241;1869;1890;21
1872;73;55,84433;9,589121;1848;2021;173
1872;75;55,731027;9,833955;1866;1939;73
1872;81;56,133911;9,056668;1867;1884;17
1872;86;55,902118;12,238497;1867;1880;13
1872;92;57,397496;9,892683;1855;1882;27
1872;106;55,934809;9,843892;1854;1881;27
1872;128;55,512352;11,287189;1866;1930;64
1872;138;55,430432;9,31255;1865;1882;17
1872;141;55,6869;12,558947;1867;1872;5
1872;142;55,7217;12,543237;1872;1913;41
1872;143;55,707689;12,555774;1856;1890;34
1872;151;54,861238;10,73061;1867;1978;111
1872;161;55,7729977;12,5000579;1871;1874;3
1872;166;56,76116;10,187328;1870;1887;17
1872;177;56,839448;8,717907;1864;1946;82
1872;182;56,453059;10,866897;1868;1938;70
1872;198;55,973781;10,234657;1852;1876;24
1872;200;55,365817;10,394151;1862;1886;24
1872;231;56,207889;9,466901;1868;1889;21
1872;232;56,327334;9,431593;1872;1877;5
1872;241;56,651494;8,934794;1855;1908;53
1872;260;55,110103;10,734595;1867;1930;63
1872;268;56,327852;10,394815;1869;1919;50
1872;274;54,950002;9,749616;1869;1874;5
1872;280;56,79505;8,36757;1868;1877;9
1872;293;55,809434;8,632002;1868;1881;13
1872;294;55,471013;9,099652;1865;2021;156
1872;295;55,499295;9,034897;1869;1874;5
1872;296;55,369252;9,052748;1844;1885;41
1872;305;55,810619;9,428677;1868;1873;5
1872;306;55,653994;9,302369;1869;1891;22
1872;308;55,671645;9,5777;1867;1939;72
1872;315;56,552152;9,40118;1868;2021;153
1872;322;54,9748134;12,2737822;1866;2021;155
1872;330;56,92528;10,018117;1866;1908;42
1872;336;56,032176;10,125522;1869;2005;136
1872;346;56,067076;10,134812;1866;2021;155
1872;13;55,18902;14,96054;1867;2021;154
1872;30;56,27228;10,05575;1869;1872;3
1872;32;56,20715;9,80963;1868;1877;9
1872;71;55,98048;12,02986;1864;1892;28
1872;103;56,27039;8,28711;1853;1894;41
1872;108;55,89553;9,71437;1867;1877;10
1872;157;54,83432;11,32731;1867;1887;20
1872;191;55,1839;11,98427;1867;1947;80
1872;192;55,28643;11,55841;1852;1916;64
1872;201;55,45808;10,37744;1859;1893;34
1872;208;55,74166;11,41925;1865;2021;156
1872;211;56,58663;10,12878;1860;1877;17
1872;235;56,14912;9,91448;1868;1939;71
1872;261;55,07418;10,458;1868;1882;14
1872;290;55,62305;8,36912;1869;1918;49
1872;334;57,00195;9,7455;1872;1885;13
1872;349;56,12853;10,16653;1857;1899;42
1873;8;55,379535;10,047905;1868;1874;6
1873;15;57,2642721;9,9501182;1868;1904;36
1873;18;57,320114;9,869439;1872;1890;18
1873;19;57,141564;10,224039;1873;1974;101
1873;36;55,306751;12,199669;1869;1924;55
1873;55;55,242371;10,53961;1866;2021;155
1873;70;55,299963;9,620241;1869;1890;21
1873;73;55,84433;9,589121;1848;2021;173
1873;75;55,731027;9,833955;1866;1939;73
1873;81;56,133911;9,056668;1867;1884;17
1873;86;55,902118;12,238497;1867;1880;13
1873;92;57,397496;9,892683;1855;1882;27
1873;96;55,610496;11,586514;1873;1917;44
1873;106;55,934809;9,843892;1854;1881;27
1873;128;55,512352;11,287189;1866;1930;64
1873;138;55,430432;9,31255;1865;1882;17
1873;142;55,7217;12,543237;1872;1913;41
1873;143;55,707689;12,555774;1856;1890;34
1873;151;54,861238;10,73061;1867;1978;111
1873;161;55,7729977;12,5000579;1871;1874;3
1873;166;56,76116;10,187328;1870;1887;17
1873;177;56,839448;8,717907;1864;1946;82
1873;182;56,453059;10,866897;1868;1938;70
1873;198;55,973781;10,234657;1852;1876;24
1873;200;55,365817;10,394151;1862;1886;24
1873;231;56,207889;9,466901;1868;1889;21
1873;232;56,327334;9,431593;1872;1877;5
1873;241;56,651494;8,934794;1855;1908;53
1873;260;55,110103;10,734595;1867;1930;63
1873;268;56,327852;10,394815;1869;1919;50
1873;274;54,950002;9,749616;1869;1874;5
1873;280;56,79505;8,36757;1868;1877;9
1873;293;55,809434;8,632002;1868;1881;13
1873;294;55,471013;9,099652;1865;2021;156
1873;295;55,499295;9,034897;1869;1874;5
1873;296;55,369252;9,052748;1844;1885;41
1873;305;55,810619;9,428677;1868;1873;5
1873;306;55,653994;9,302369;1869;1891;22
1873;308;55,671645;9,5777;1867;1939;72
1873;310;56,956521;9,435052;1873;1887;14
1873;315;56,552152;9,40118;1868;2021;153
1873;322;54,9748134;12,2737822;1866;2021;155
1873;330;56,92528;10,018117;1866;1908;42
1873;336;56,032176;10,125522;1869;2005;136
1873;346;56,067076;10,134812;1866;2021;155
1873;13;55,18902;14,96054;1867;2021;154
1873;32;56,20715;9,80963;1868;1877;9
1873;71;55,98048;12,02986;1864;1892;28
1873;103;56,27039;8,28711;1853;1894;41
1873;108;55,89553;9,71437;1867;1877;10
1873;157;54,83432;11,32731;1867;1887;20
1873;191;55,1839;11,98427;1867;1947;80
1873;192;55,28643;11,55841;1852;1916;64
1873;201;55,45808;10,37744;1859;1893;34
1873;208;55,74166;11,41925;1865;2021;156
1873;211;56,58663;10,12878;1860;1877;17
1873;235;56,14912;9,91448;1868;1939;71
1873;261;55,07418;10,458;1868;1882;14
1873;290;55,62305;8,36912;1869;1918;49
1873;334;57,00195;9,7455;1872;1885;13
1873;349;56,12853;10,16653;1857;1899;42
1874;8;55,379535;10,047905;1868;1874;6
1874;15;57,2642721;9,9501182;1868;1904;36
1874;18;57,320114;9,869439;1872;1890;18
1874;19;57,141564;10,224039;1873;1974;101
1874;33;56,407535;9,820916;1874;1886;12
1874;36;55,306751;12,199669;1869;1924;55
1874;55;55,242371;10,53961;1866;2021;155
1874;57;55,766103;12,569045;1874;1878;4
1874;70;55,299963;9,620241;1869;1890;21
1874;73;55,84433;9,589121;1848;2021;173
1874;75;55,731027;9,833955;1866;1939;73
1874;81;56,133911;9,056668;1867;1884;17
1874;86;55,902118;12,238497;1867;1880;13
1874;92;57,397496;9,892683;1855;1882;27
1874;96;55,610496;11,586514;1873;1917;44
1874;106;55,934809;9,843892;1854;1881;27
1874;128;55,512352;11,287189;1866;1930;64
1874;138;55,430432;9,31255;1865;1882;17
1874;142;55,7217;12,543237;1872;1913;41
1874;143;55,707689;12,555774;1856;1890;34
1874;151;54,861238;10,73061;1867;1978;111
1874;161;55,7729977;12,5000579;1871;1874;3
1874;166;56,76116;10,187328;1870;1887;17
1874;177;56,839448;8,717907;1864;1946;82
1874;182;56,453059;10,866897;1868;1938;70
1874;198;55,973781;10,234657;1852;1876;24
1874;200;55,365817;10,394151;1862;1886;24
1874;231;56,207889;9,466901;1868;1889;21
1874;232;56,327334;9,431593;1872;1877;5
1874;241;56,651494;8,934794;1855;1908;53
1874;260;55,110103;10,734595;1867;1930;63
1874;268;56,327852;10,394815;1869;1919;50
1874;274;54,950002;9,749616;1869;1874;5
1874;280;56,79505;8,36757;1868;1877;9
1874;293;55,809434;8,632002;1868;1881;13
1874;294;55,471013;9,099652;1865;2021;156
1874;295;55,499295;9,034897;1869;1874;5
1874;296;55,369252;9,052748;1844;1885;41
1874;306;55,653994;9,302369;1869;1891;22
1874;308;55,671645;9,5777;1867;1939;72
1874;310;56,956521;9,435052;1873;1887;14
1874;315;56,552152;9,40118;1868;2021;153
1874;322;54,9748134;12,2737822;1866;2021;155
1874;330;56,92528;10,018117;1866;1908;42
1874;336;56,032176;10,125522;1869;2005;136
1874;346;56,067076;10,134812;1866;2021;155
1874;13;55,18902;14,96054;1867;2021;154
1874;32;56,20715;9,80963;1868;1877;9
1874;71;55,98048;12,02986;1864;1892;28
1874;103;56,27039;8,28711;1853;1894;41
1874;108;55,89553;9,71437;1867;1877;10
1874;157;54,83432;11,32731;1867;1887;20
1874;191;55,1839;11,98427;1867;1947;80
1874;192;55,28643;11,55841;1852;1916;64
1874;201;55,45808;10,37744;1859;1893;34
1874;208;55,74166;11,41925;1865;2021;156
1874;211;56,58663;10,12878;1860;1877;17
1874;235;56,14912;9,91448;1868;1939;71
1874;261;55,07418;10,458;1868;1882;14
1874;264;56,19409;10,67727;1874;1890;16
1874;290;55,62305;8,36912;1869;1918;49
1874;334;57,00195;9,7455;1872;1885;13
1874;349;56,12853;10,16653;1857;1899;42
1875;15;57,2642721;9,9501182;1868;1904;36
1875;18;57,320114;9,869439;1872;1890;18
1875;19;57,141564;10,224039;1873;1974;101
1875;33;56,407535;9,820916;1874;1886;12
1875;36;55,306751;12,199669;1869;1924;55
1875;44;57,471613;10,410374;1875;1919;44
1875;55;55,242371;10,53961;1866;2021;155
1875;57;55,766103;12,569045;1874;1878;4
1875;70;55,299963;9,620241;1869;1890;21
1875;73;55,84433;9,589121;1848;2021;173
1875;75;55,731027;9,833955;1866;1939;73
1875;81;56,133911;9,056668;1867;1884;17
1875;86;55,902118;12,238497;1867;1880;13
1875;92;57,397496;9,892683;1855;1882;27
1875;96;55,610496;11,586514;1873;1917;44
1875;106;55,934809;9,843892;1854;1881;27
1875;128;55,512352;11,287189;1866;1930;64
1875;138;55,430432;9,31255;1865;1882;17
1875;142;55,7217;12,543237;1872;1913;41
1875;143;55,707689;12,555774;1856;1890;34
1875;151;54,861238;10,73061;1867;1978;111
1875;166;56,76116;10,187328;1870;1887;17
1875;177;56,839448;8,717907;1864;1946;82
1875;182;56,453059;10,866897;1868;1938;70
1875;198;55,973781;10,234657;1852;1876;24
1875;200;55,365817;10,394151;1862;1886;24
1875;231;56,207889;9,466901;1868;1889;21
1875;232;56,327334;9,431593;1872;1877;5
1875;241;56,651494;8,934794;1855;1908;53
1875;260;55,110103;10,734595;1867;1930;63
1875;268;56,327852;10,394815;1869;1919;50
1875;280;56,79505;8,36757;1868;1877;9
1875;293;55,809434;8,632002;1868;1881;13
1875;294;55,471013;9,099652;1865;2021;156
1875;296;55,369252;9,052748;1844;1885;41
1875;306;55,653994;9,302369;1869;1891;22
1875;308;55,671645;9,5777;1867;1939;72
1875;310;56,956521;9,435052;1873;1887;14
1875;315;56,552152;9,40118;1868;2021;153
1875;322;54,9748134;12,2737822;1866;2021;155
1875;330;56,92528;10,018117;1866;1908;42
1875;336;56,032176;10,125522;1869;2005;136
1875;341;56,262495;10,268877;1875;1920;45
1875;346;56,067076;10,134812;1866;2021;155
1875;13;55,18902;14,96054;1867;2021;154
1875;32;56,20715;9,80963;1868;1877;9
1875;71;55,98048;12,02986;1864;1892;28
1875;103;56,27039;8,28711;1853;1894;41
1875;108;55,89553;9,71437;1867;1877;10
1875;157;54,83432;11,32731;1867;1887;20
1875;164;56,52729;9,84853;1875;1878;3
1875;191;55,1839;11,98427;1867;1947;80
1875;192;55,28643;11,55841;1852;1916;64
1875;201;55,45808;10,37744;1859;1893;34
1875;208;55,74166;11,41925;1865;2021;156
1875;211;56,58663;10,12878;1860;1877;17
1875;235;56,14912;9,91448;1868;1939;71
1875;261;55,07418;10,458;1868;1882;14
1875;264;56,19409;10,67727;1874;1890;16
1875;290;55,62305;8,36912;1869;1918;49
1875;334;57,00195;9,7455;1872;1885;13
1875;349;56,12853;10,16653;1857;1899;42
1876;15;57,2642721;9,9501182;1868;1904;36
1876;18;57,320114;9,869439;1872;1890;18
1876;19;57,141564;10,224039;1873;1974;101
1876;33;56,407535;9,820916;1874;1886;12
1876;36;55,306751;12,199669;1869;1924;55
1876;44;57,471613;10,410374;1875;1919;44
1876;55;55,242371;10,53961;1866;2021;155
1876;57;55,766103;12,569045;1874;1878;4
1876;70;55,299963;9,620241;1869;1890;21
1876;73;55,84433;9,589121;1848;2021;173
1876;75;55,731027;9,833955;1866;1939;73
1876;81;56,133911;9,056668;1867;1884;17
1876;86;55,902118;12,238497;1867;1880;13
1876;92;57,397496;9,892683;1855;1882;27
1876;96;55,610496;11,586514;1873;1917;44
1876;106;55,934809;9,843892;1854;1881;27
1876;128;55,512352;11,287189;1866;1930;64
1876;138;55,430432;9,31255;1865;1882;17
1876;142;55,7217;12,543237;1872;1913;41
1876;143;55,707689;12,555774;1856;1890;34
1876;151;54,861238;10,73061;1867;1978;111
1876;166;56,76116;10,187328;1870;1887;17
1876;177;56,839448;8,717907;1864;1946;82
1876;182;56,453059;10,866897;1868;1938;70
1876;198;55,973781;10,234657;1852;1876;24
1876;200;55,365817;10,394151;1862;1886;24
1876;231;56,207889;9,466901;1868;1889;21
1876;232;56,327334;9,431593;1872;1877;5
1876;241;56,651494;8,934794;1855;1908;53
1876;260;55,110103;10,734595;1867;1930;63
1876;268;56,327852;10,394815;1869;1919;50
1876;280;56,79505;8,36757;1868;1877;9
1876;293;55,809434;8,632002;1868;1881;13
1876;294;55,471013;9,099652;1865;2021;156
1876;296;55,369252;9,052748;1844;1885;41
1876;306;55,653994;9,302369;1869;1891;22
1876;308;55,671645;9,5777;1867;1939;72
1876;310;56,956521;9,435052;1873;1887;14
1876;315;56,552152;9,40118;1868;2021;153
1876;322;54,9748134;12,2737822;1866;2021;155
1876;330;56,92528;10,018117;1866;1908;42
1876;336;56,032176;10,125522;1869;2005;136
1876;341;56,262495;10,268877;1875;1920;45
1876;346;56,067076;10,134812;1866;2021;155
1876;13;55,18902;14,96054;1867;2021;154
1876;29;56,328077;10,04661;1876;2021;145
1876;32;56,20715;9,80963;1868;1877;9
1876;71;55,98048;12,02986;1864;1892;28
1876;103;56,27039;8,28711;1853;1894;41
1876;108;55,89553;9,71437;1867;1877;10
1876;157;54,83432;11,32731;1867;1887;20
1876;164;56,52729;9,84853;1875;1878;3
1876;191;55,1839;11,98427;1867;1947;80
1876;192;55,28643;11,55841;1852;1916;64
1876;201;55,45808;10,37744;1859;1893;34
1876;208;55,74166;11,41925;1865;2021;156
1876;211;56,58663;10,12878;1860;1877;17
1876;235;56,14912;9,91448;1868;1939;71
1876;261;55,07418;10,458;1868;1882;14
1876;264;56,19409;10,67727;1874;1890;16
1876;290;55,62305;8,36912;1869;1918;49
1876;334;57,00195;9,7455;1872;1885;13
1876;349;56,12853;10,16653;1857;1899;42
1877;6;55,269626;10,11524;1877;2009;132
1877;15;57,2642721;9,9501182;1868;1904;36
1877;18;57,320114;9,869439;1872;1890;18
1877;19;57,141564;10,224039;1873;1974;101
1877;33;56,407535;9,820916;1874;1886;12
1877;36;55,306751;12,199669;1869;1924;55
1877;44;57,471613;10,410374;1875;1919;44
1877;55;55,242371;10,53961;1866;2021;155
1877;57;55,766103;12,569045;1874;1878;4
1877;67;54,7584557;11,7799705;1877;1905;28
1877;70;55,299963;9,620241;1869;1890;21
1877;73;55,84433;9,589121;1848;2021;173
1877;75;55,731027;9,833955;1866;1939;73
1877;81;56,133911;9,056668;1867;1884;17
1877;86;55,902118;12,238497;1867;1880;13
1877;92;57,397496;9,892683;1855;1882;27
1877;96;55,610496;11,586514;1873;1917;44
1877;106;55,934809;9,843892;1854;1881;27
1877;126;57,16496;9,729678;1877;1951;74
1877;128;55,512352;11,287189;1866;1930;64
1877;138;55,430432;9,31255;1865;1882;17
1877;142;55,7217;12,543237;1872;1913;41
1877;143;55,707689;12,555774;1856;1890;34
1877;145;55,682456;12,569828;1877;2021;144
1877;151;54,861238;10,73061;1867;1978;111
1877;166;56,76116;10,187328;1870;1887;17
1877;177;56,839448;8,717907;1864;1946;82
1877;182;56,453059;10,866897;1868;1938;70
1877;200;55,365817;10,394151;1862;1886;24
1877;231;56,207889;9,466901;1868;1889;21
1877;232;56,327334;9,431593;1872;1877;5
1877;234;56,026435;9,863179;1877;1887;10
1877;241;56,651494;8,934794;1855;1908;53
1877;260;55,110103;10,734595;1867;1930;63
1877;268;56,327852;10,394815;1869;1919;50
1877;280;56,79505;8,36757;1868;1877;9
1877;293;55,809434;8,632002;1868;1881;13
1877;294;55,471013;9,099652;1865;2021;156
1877;296;55,369252;9,052748;1844;1885;41
1877;306;55,653994;9,302369;1869;1891;22
1877;308;55,671645;9,5777;1867;1939;72
1877;310;56,956521;9,435052;1873;1887;14
1877;315;56,552152;9,40118;1868;2021;153
1877;322;54,9748134;12,2737822;1866;2021;155
1877;330;56,92528;10,018117;1866;1908;42
1877;336;56,032176;10,125522;1869;2005;136
1877;341;56,262495;10,268877;1875;1920;45
1877;346;56,067076;10,134812;1866;2021;155
1877;13;55,18902;14,96054;1867;2021;154
1877;29;56,328077;10,04661;1876;2021;145
1877;32;56,20715;9,80963;1868;1877;9
1877;71;55,98048;12,02986;1864;1892;28
1877;103;56,27039;8,28711;1853;1894;41
1877;108;55,89553;9,71437;1867;1877;10
1877;157;54,83432;11,32731;1867;1887;20
1877;164;56,52729;9,84853;1875;1878;3
1877;191;55,1839;11,98427;1867;1947;80
1877;192;55,28643;11,55841;1852;1916;64
1877;201;55,45808;10,37744;1859;1893;34
1877;208;55,74166;11,41925;1865;2021;156
1877;211;56,58663;10,12878;1860;1877;17
1877;235;56,14912;9,91448;1868;1939;71
1877;261;55,07418;10,458;1868;1882;14
1877;264;56,19409;10,67727;1874;1890;16
1877;290;55,62305;8,36912;1869;1918;49
1877;311;56,37581;9,39626;1877;1895;18
1877;334;57,00195;9,7455;1872;1885;13
1877;349;56,12853;10,16653;1857;1899;42
1878;6;55,269626;10,11524;1877;2009;132
1878;15;57,2642721;9,9501182;1868;1904;36
1878;18;57,320114;9,869439;1872;1890;18
1878;19;57,141564;10,224039;1873;1974;101
1878;33;56,407535;9,820916;1874;1886;12
1878;36;55,306751;12,199669;1869;1924;55
1878;44;57,471613;10,410374;1875;1919;44
1878;55;55,242371;10,53961;1866;2021;155
1878;57;55,766103;12,569045;1874;1878;4
1878;66;54,790388;11,944494;1878;1937;59
1878;67;54,7584557;11,7799705;1877;1905;28
1878;70;55,299963;9,620241;1869;1890;21
1878;73;55,84433;9,589121;1848;2021;173
1878;75;55,731027;9,833955;1866;1939;73
1878;81;56,133911;9,056668;1867;1884;17
1878;86;55,902118;12,238497;1867;1880;13
1878;92;57,397496;9,892683;1855;1882;27
1878;96;55,610496;11,586514;1873;1917;44
1878;106;55,934809;9,843892;1854;1881;27
1878;126;57,16496;9,729678;1877;1951;74
1878;128;55,512352;11,287189;1866;1930;64
1878;138;55,430432;9,31255;1865;1882;17
1878;142;55,7217;12,543237;1872;1913;41
1878;143;55,707689;12,555774;1856;1890;34
1878;145;55,682456;12,569828;1877;2021;144
1878;151;54,861238;10,73061;1867;1978;111
1878;166;56,76116;10,187328;1870;1887;17
1878;177;56,839448;8,717907;1864;1946;82
1878;182;56,453059;10,866897;1868;1938;70
1878;200;55,365817;10,394151;1862;1886;24
1878;216;55,850528;8,7593;1878;1891;13
1878;231;56,207889;9,466901;1868;1889;21
1878;234;56,026435;9,863179;1877;1887;10
1878;241;56,651494;8,934794;1855;1908;53
1878;260;55,110103;10,734595;1867;1930;63
1878;268;56,327852;10,394815;1869;1919;50
1878;293;55,809434;8,632002;1868;1881;13
1878;294;55,471013;9,099652;1865;2021;156
1878;296;55,369252;9,052748;1844;1885;41
1878;306;55,653994;9,302369;1869;1891;22
1878;308;55,671645;9,5777;1867;1939;72
1878;310;56,956521;9,435052;1873;1887;14
1878;315;56,552152;9,40118;1868;2021;153
1878;322;54,9748134;12,2737822;1866;2021;155
1878;330;56,92528;10,018117;1866;1908;42
1878;336;56,032176;10,125522;1869;2005;136
1878;341;56,262495;10,268877;1875;1920;45
1878;346;56,067076;10,134812;1866;2021;155
1878;13;55,18902;14,96054;1867;2021;154
1878;29;56,328077;10,04661;1876;2021;145
1878;71;55,98048;12,02986;1864;1892;28
1878;103;56,27039;8,28711;1853;1894;41
1878;157;54,83432;11,32731;1867;1887;20
1878;164;56,52729;9,84853;1875;1878;3
1878;191;55,1839;11,98427;1867;1947;80
1878;192;55,28643;11,55841;1852;1916;64
1878;201;55,45808;10,37744;1859;1893;34
1878;208;55,74166;11,41925;1865;2021;156
1878;235;56,14912;9,91448;1868;1939;71
1878;261;55,07418;10,458;1868;1882;14
1878;264;56,19409;10,67727;1874;1890;16
1878;284;55,12508;8,76169;1878;1879;1
1878;290;55,62305;8,36912;1869;1918;49
1878;311;56,37581;9,39626;1877;1895;18
1878;334;57,00195;9,7455;1872;1885;13
1878;349;56,12853;10,16653;1857;1899;42
1879;6;55,269626;10,11524;1877;2009;132
1879;15;57,2642721;9,9501182;1868;1904;36
1879;18;57,320114;9,869439;1872;1890;18
1879;19;57,141564;10,224039;1873;1974;101
1879;33;56,407535;9,820916;1874;1886;12
1879;36;55,306751;12,199669;1869;1924;55
1879;44;57,471613;10,410374;1875;1919;44
1879;55;55,242371;10,53961;1866;2021;155
1879;66;54,790388;11,944494;1878;1937;59
1879;67;54,7584557;11,7799705;1877;1905;28
1879;70;55,299963;9,620241;1869;1890;21
1879;73;55,84433;9,589121;1848;2021;173
1879;75;55,731027;9,833955;1866;1939;73
1879;81;56,133911;9,056668;1867;1884;17
1879;86;55,902118;12,238497;1867;1880;13
1879;92;57,397496;9,892683;1855;1882;27
1879;96;55,610496;11,586514;1873;1917;44
1879;106;55,934809;9,843892;1854;1881;27
1879;126;57,16496;9,729678;1877;1951;74
1879;128;55,512352;11,287189;1866;1930;64
1879;138;55,430432;9,31255;1865;1882;17
1879;142;55,7217;12,543237;1872;1913;41
1879;143;55,707689;12,555774;1856;1890;34
1879;145;55,682456;12,569828;1877;2021;144
1879;151;54,861238;10,73061;1867;1978;111
1879;166;56,76116;10,187328;1870;1887;17
1879;177;56,839448;8,717907;1864;1946;82
1879;182;56,453059;10,866897;1868;1938;70
1879;200;55,365817;10,394151;1862;1886;24
1879;216;55,850528;8,7593;1878;1891;13
1879;231;56,207889;9,466901;1868;1889;21
1879;234;56,026435;9,863179;1877;1887;10
1879;241;56,651494;8,934794;1855;1908;53
1879;260;55,110103;10,734595;1867;1930;63
1879;268;56,327852;10,394815;1869;1919;50
1879;293;55,809434;8,632002;1868;1881;13
1879;294;55,471013;9,099652;1865;2021;156
1879;296;55,369252;9,052748;1844;1885;41
1879;306;55,653994;9,302369;1869;1891;22
1879;308;55,671645;9,5777;1867;1939;72
1879;310;56,956521;9,435052;1873;1887;14
1879;315;56,552152;9,40118;1868;2021;153
1879;322;54,9748134;12,2737822;1866;2021;155
1879;330;56,92528;10,018117;1866;1908;42
1879;336;56,032176;10,125522;1869;2005;136
1879;341;56,262495;10,268877;1875;1920;45
1879;345;56,125512;10,059451;1879;1888;9
1879;346;56,067076;10,134812;1866;2021;155
1879;13;55,18902;14,96054;1867;2021;154
1879;29;56,328077;10,04661;1876;2021;145
1879;71;55,98048;12,02986;1864;1892;28
1879;103;56,27039;8,28711;1853;1894;41
1879;157;54,83432;11,32731;1867;1887;20
1879;191;55,1839;11,98427;1867;1947;80
1879;192;55,28643;11,55841;1852;1916;64
1879;201;55,45808;10,37744;1859;1893;34
1879;202;55,39817;10,3966;1879;1920;41
1879;208;55,74166;11,41925;1865;2021;156
1879;235;56,14912;9,91448;1868;1939;71
1879;261;55,07418;10,458;1868;1882;14
1879;264;56,19409;10,67727;1874;1890;16
1879;284;55,12508;8,76169;1878;1879;1
1879;287;55,01055;8,77735;1879;1884;5
1879;290;55,62305;8,36912;1869;1918;49
1879;304;55,72746;9,53248;1879;1942;63
1879;311;56,37581;9,39626;1877;1895;18
1879;334;57,00195;9,7455;1872;1885;13
1879;349;56,12853;10,16653;1857;1899;42
1880;6;55,269626;10,11524;1877;2009;132
1880;15;57,2642721;9,9501182;1868;1904;36
1880;18;57,320114;9,869439;1872;1890;18
1880;19;57,141564;10,224039;1873;1974;101
1880;33;56,407535;9,820916;1874;1886;12
1880;36;55,306751;12,199669;1869;1924;55
1880;44;57,471613;10,410374;1875;1919;44
1880;55;55,242371;10,53961;1866;2021;155
1880;66;54,790388;11,944494;1878;1937;59
1880;67;54,7584557;11,7799705;1877;1905;28
1880;70;55,299963;9,620241;1869;1890;21
1880;73;55,84433;9,589121;1848;2021;173
1880;75;55,731027;9,833955;1866;1939;73
1880;81;56,133911;9,056668;1867;1884;17
1880;86;55,902118;12,238497;1867;1880;13
1880;92;57,397496;9,892683;1855;1882;27
1880;96;55,610496;11,586514;1873;1917;44
1880;106;55,934809;9,843892;1854;1881;27
1880;126;57,16496;9,729678;1877;1951;74
1880;128;55,512352;11,287189;1866;1930;64
1880;138;55,430432;9,31255;1865;1882;17
1880;142;55,7217;12,543237;1872;1913;41
1880;143;55,707689;12,555774;1856;1890;34
1880;145;55,682456;12,569828;1877;2021;144
1880;151;54,861238;10,73061;1867;1978;111
1880;166;56,76116;10,187328;1870;1887;17
1880;176;55,460727;9,822756;1880;1960;80
1880;177;56,839448;8,717907;1864;1946;82
1880;182;56,453059;10,866897;1868;1938;70
1880;200;55,365817;10,394151;1862;1886;24
1880;216;55,850528;8,7593;1878;1891;13
1880;231;56,207889;9,466901;1868;1889;21
1880;234;56,026435;9,863179;1877;1887;10
1880;241;56,651494;8,934794;1855;1908;53
1880;260;55,110103;10,734595;1867;1930;63
1880;268;56,327852;10,394815;1869;1919;50
1880;293;55,809434;8,632002;1868;1881;13
1880;294;55,471013;9,099652;1865;2021;156
1880;296;55,369252;9,052748;1844;1885;41
1880;306;55,653994;9,302369;1869;1891;22
1880;308;55,671645;9,5777;1867;1939;72
1880;310;56,956521;9,435052;1873;1887;14
1880;315;56,552152;9,40118;1868;2021;153
1880;322;54,9748134;12,2737822;1866;2021;155
1880;330;56,92528;10,018117;1866;1908;42
1880;336;56,032176;10,125522;1869;2005;136
1880;341;56,262495;10,268877;1875;1920;45
1880;345;56,125512;10,059451;1879;1888;9
1880;346;56,067076;10,134812;1866;2021;155
1880;13;55,18902;14,96054;1867;2021;154
1880;29;56,328077;10,04661;1876;2021;145
1880;41;55,67571;12,54451;1880;1889;9
1880;47;55,82879;12,15363;1880;1917;37
1880;71;55,98048;12,02986;1864;1892;28
1880;103;56,27039;8,28711;1853;1894;41
1880;157;54,83432;11,32731;1867;1887;20
1880;191;55,1839;11,98427;1867;1947;80
1880;192;55,28643;11,55841;1852;1916;64
1880;201;55,45808;10,37744;1859;1893;34
1880;202;55,39817;10,3966;1879;1920;41
1880;208;55,74166;11,41925;1865;2021;156
1880;212;56,51632;10,2095;1880;1917;37
1880;235;56,14912;9,91448;1868;1939;71
1880;261;55,07418;10,458;1868;1882;14
1880;264;56,19409;10,67727;1874;1890;16
1880;287;55,01055;8,77735;1879;1884;5
1880;290;55,62305;8,36912;1869;1918;49
1880;304;55,72746;9,53248;1879;1942;63
1880;311;56,37581;9,39626;1877;1895;18
1880;334;57,00195;9,7455;1872;1885;13
1880;349;56,12853;10,16653;1857;1899;42
1881;6;55,269626;10,11524;1877;2009;132
1881;15;57,2642721;9,9501182;1868;1904;36
1881;18;57,320114;9,869439;1872;1890;18
1881;19;57,141564;10,224039;1873;1974;101
1881;33;56,407535;9,820916;1874;1886;12
1881;36;55,306751;12,199669;1869;1924;55
1881;44;57,471613;10,410374;1875;1919;44
1881;55;55,242371;10,53961;1866;2021;155
1881;66;54,790388;11,944494;1878;1937;59
1881;67;54,7584557;11,7799705;1877;1905;28
1881;70;55,299963;9,620241;1869;1890;21
1881;73;55,84433;9,589121;1848;2021;173
1881;75;55,731027;9,833955;1866;1939;73
1881;81;56,133911;9,056668;1867;1884;17
1881;92;57,397496;9,892683;1855;1882;27
1881;96;55,610496;11,586514;1873;1917;44
1881;106;55,934809;9,843892;1854;1881;27
1881;126;57,16496;9,729678;1877;1951;74
1881;128;55,512352;11,287189;1866;1930;64
1881;138;55,430432;9,31255;1865;1882;17
1881;142;55,7217;12,543237;1872;1913;41
1881;143;55,707689;12,555774;1856;1890;34
1881;145;55,682456;12,569828;1877;2021;144
1881;151;54,861238;10,73061;1867;1978;111
1881;166;56,76116;10,187328;1870;1887;17
1881;176;55,460727;9,822756;1880;1960;80
1881;177;56,839448;8,717907;1864;1946;82
1881;182;56,453059;10,866897;1868;1938;70
1881;200;55,365817;10,394151;1862;1886;24
1881;216;55,850528;8,7593;1878;1891;13
1881;231;56,207889;9,466901;1868;1889;21
1881;234;56,026435;9,863179;1877;1887;10
1881;241;56,651494;8,934794;1855;1908;53
1881;260;55,110103;10,734595;1867;1930;63
1881;268;56,327852;10,394815;1869;1919;50
1881;293;55,809434;8,632002;1868;1881;13
1881;294;55,471013;9,099652;1865;2021;156
1881;296;55,369252;9,052748;1844;1885;41
1881;306;55,653994;9,302369;1869;1891;22
1881;308;55,671645;9,5777;1867;1939;72
1881;310;56,956521;9,435052;1873;1887;14
1881;315;56,552152;9,40118;1868;2021;153
1881;322;54,9748134;12,2737822;1866;2021;155
1881;330;56,92528;10,018117;1866;1908;42
1881;336;56,032176;10,125522;1869;2005;136
1881;341;56,262495;10,268877;1875;1920;45
1881;345;56,125512;10,059451;1879;1888;9
1881;346;56,067076;10,134812;1866;2021;155
1881;13;55,18902;14,96054;1867;2021;154
1881;29;56,328077;10,04661;1876;2021;145
1881;41;55,67571;12,54451;1880;1889;9
1881;47;55,82879;12,15363;1880;1917;37
1881;71;55,98048;12,02986;1864;1892;28
1881;103;56,27039;8,28711;1853;1894;41
1881;157;54,83432;11,32731;1867;1887;20
1881;191;55,1839;11,98427;1867;1947;80
1881;192;55,28643;11,55841;1852;1916;64
1881;201;55,45808;10,37744;1859;1893;34
1881;202;55,39817;10,3966;1879;1920;41
1881;208;55,74166;11,41925;1865;2021;156
1881;212;56,51632;10,2095;1880;1917;37
1881;235;56,14912;9,91448;1868;1939;71
1881;261;55,07418;10,458;1868;1882;14
1881;264;56,19409;10,67727;1874;1890;16
1881;287;55,01055;8,77735;1879;1884;5
1881;290;55,62305;8,36912;1869;1918;49
1881;304;55,72746;9,53248;1879;1942;63
1881;311;56,37581;9,39626;1877;1895;18
1881;334;57,00195;9,7455;1872;1885;13
1881;349;56,12853;10,16653;1857;1899;42
1882;6;55,269626;10,11524;1877;2009;132
1882;15;57,2642721;9,9501182;1868;1904;36
1882;18;57,320114;9,869439;1872;1890;18
1882;19;57,141564;10,224039;1873;1974;101
1882;33;56,407535;9,820916;1874;1886;12
1882;36;55,306751;12,199669;1869;1924;55
1882;44;57,471613;10,410374;1875;1919;44
1882;55;55,242371;10,53961;1866;2021;155
1882;66;54,790388;11,944494;1878;1937;59
1882;67;54,7584557;11,7799705;1877;1905;28
1882;70;55,299963;9,620241;1869;1890;21
1882;73;55,84433;9,589121;1848;2021;173
1882;75;55,731027;9,833955;1866;1939;73
1882;81;56,133911;9,056668;1867;1884;17
1882;92;57,397496;9,892683;1855;1882;27
1882;96;55,610496;11,586514;1873;1917;44
1882;126;57,16496;9,729678;1877;1951;74
1882;128;55,512352;11,287189;1866;1930;64
1882;138;55,430432;9,31255;1865;1882;17
1882;142;55,7217;12,543237;1872;1913;41
1882;143;55,707689;12,555774;1856;1890;34
1882;145;55,682456;12,569828;1877;2021;144
1882;151;54,861238;10,73061;1867;1978;111
1882;166;56,76116;10,187328;1870;1887;17
1882;176;55,460727;9,822756;1880;1960;80
1882;177;56,839448;8,717907;1864;1946;82
1882;182;56,453059;10,866897;1868;1938;70
1882;188;55,513946;10,178703;1882;1938;56
1882;200;55,365817;10,394151;1862;1886;24
1882;216;55,850528;8,7593;1878;1891;13
1882;231;56,207889;9,466901;1868;1889;21
1882;234;56,026435;9,863179;1877;1887;10
1882;241;56,651494;8,934794;1855;1908;53
1882;257;55,074867;10,467835;1882;1953;71
1882;260;55,110103;10,734595;1867;1930;63
1882;268;56,327852;10,394815;1869;1919;50
1882;294;55,471013;9,099652;1865;2021;156
1882;296;55,369252;9,052748;1844;1885;41
1882;306;55,653994;9,302369;1869;1891;22
1882;308;55,671645;9,5777;1867;1939;72
1882;310;56,956521;9,435052;1873;1887;14
1882;315;56,552152;9,40118;1868;2021;153
1882;322;54,9748134;12,2737822;1866;2021;155
1882;330;56,92528;10,018117;1866;1908;42
1882;336;56,032176;10,125522;1869;2005;136
1882;341;56,262495;10,268877;1875;1920;45
1882;345;56,125512;10,059451;1879;1888;9
1882;346;56,067076;10,134812;1866;2021;155
1882;13;55,18902;14,96054;1867;2021;154
1882;29;56,328077;10,04661;1876;2021;145
1882;41;55,67571;12,54451;1880;1889;9
1882;47;55,82879;12,15363;1880;1917;37
1882;71;55,98048;12,02986;1864;1892;28
1882;103;56,27039;8,28711;1853;1894;41
1882;153;56,52478;8,20986;1882;1888;6
1882;157;54,83432;11,32731;1867;1887;20
1882;191;55,1839;11,98427;1867;1947;80
1882;192;55,28643;11,55841;1852;1916;64
1882;201;55,45808;10,37744;1859;1893;34
1882;202;55,39817;10,3966;1879;1920;41
1882;208;55,74166;11,41925;1865;2021;156
1882;212;56,51632;10,2095;1880;1917;37
1882;235;56,14912;9,91448;1868;1939;71
1882;261;55,07418;10,458;1868;1882;14
1882;264;56,19409;10,67727;1874;1890;16
1882;287;55,01055;8,77735;1879;1884;5
1882;290;55,62305;8,36912;1869;1918;49
1882;304;55,72746;9,53248;1879;1942;63
1882;311;56,37581;9,39626;1877;1895;18
1882;334;57,00195;9,7455;1872;1885;13
1882;349;56,12853;10,16653;1857;1899;42
1883;6;55,269626;10,11524;1877;2009;132
1883;15;57,2642721;9,9501182;1868;1904;36
1883;18;57,320114;9,869439;1872;1890;18
1883;19;57,141564;10,224039;1873;1974;101
1883;33;56,407535;9,820916;1874;1886;12
1883;36;55,306751;12,199669;1869;1924;55
1883;44;57,471613;10,410374;1875;1919;44
1883;55;55,242371;10,53961;1866;2021;155
1883;66;54,790388;11,944494;1878;1937;59
1883;67;54,7584557;11,7799705;1877;1905;28
1883;70;55,299963;9,620241;1869;1890;21
1883;73;55,84433;9,589121;1848;2021;173
1883;75;55,731027;9,833955;1866;1939;73
1883;81;56,133911;9,056668;1867;1884;17
1883;96;55,610496;11,586514;1873;1917;44
1883;126;57,16496;9,729678;1877;1951;74
1883;128;55,512352;11,287189;1866;1930;64
1883;142;55,7217;12,543237;1872;1913;41
1883;143;55,707689;12,555774;1856;1890;34
1883;145;55,682456;12,569828;1877;2021;144
1883;151;54,861238;10,73061;1867;1978;111
1883;166;56,76116;10,187328;1870;1887;17
1883;176;55,460727;9,822756;1880;1960;80
1883;177;56,839448;8,717907;1864;1946;82
1883;182;56,453059;10,866897;1868;1938;70
1883;188;55,513946;10,178703;1882;1938;56
1883;200;55,365817;10,394151;1862;1886;24
1883;216;55,850528;8,7593;1878;1891;13
1883;231;56,207889;9,466901;1868;1889;21
1883;234;56,026435;9,863179;1877;1887;10
1883;241;56,651494;8,934794;1855;1908;53
1883;257;55,074867;10,467835;1882;1953;71
1883;260;55,110103;10,734595;1867;1930;63
1883;268;56,327852;10,394815;1869;1919;50
1883;294;55,471013;9,099652;1865;2021;156
1883;296;55,369252;9,052748;1844;1885;41
1883;306;55,653994;9,302369;1869;1891;22
1883;308;55,671645;9,5777;1867;1939;72
1883;310;56,956521;9,435052;1873;1887;14
1883;315;56,552152;9,40118;1868;2021;153
1883;321;54,9909127;12,4546417;1883;1891;8
1883;322;54,9748134;12,2737822;1866;2021;155
1883;330;56,92528;10,018117;1866;1908;42
1883;336;56,032176;10,125522;1869;2005;136
1883;341;56,262495;10,268877;1875;1920;45
1883;345;56,125512;10,059451;1879;1888;9
1883;346;56,067076;10,134812;1866;2021;155
1883;13;55,18902;14,96054;1867;2021;154
1883;29;56,328077;10,04661;1876;2021;145
1883;41;55,67571;12,54451;1880;1889;9
1883;47;55,82879;12,15363;1880;1917;37
1883;71;55,98048;12,02986;1864;1892;28
1883;103;56,27039;8,28711;1853;1894;41
1883;153;56,52478;8,20986;1882;1888;6
1883;157;54,83432;11,32731;1867;1887;20
1883;191;55,1839;11,98427;1867;1947;80
1883;192;55,28643;11,55841;1852;1916;64
1883;193;55,94243;10,2267;1883;1889;6
1883;201;55,45808;10,37744;1859;1893;34
1883;202;55,39817;10,3966;1879;1920;41
1883;208;55,74166;11,41925;1865;2021;156
1883;212;56,51632;10,2095;1880;1917;37
1883;235;56,14912;9,91448;1868;1939;71
1883;264;56,19409;10,67727;1874;1890;16
1883;287;55,01055;8,77735;1879;1884;5
1883;290;55,62305;8,36912;1869;1918;49
1883;304;55,72746;9,53248;1879;1942;63
1883;311;56,37581;9,39626;1877;1895;18
1883;334;57,00195;9,7455;1872;1885;13
1883;349;56,12853;10,16653;1857;1899;42
1884;6;55,269626;10,11524;1877;2009;132
1884;15;57,2642721;9,9501182;1868;1904;36
1884;18;57,320114;9,869439;1872;1890;18
1884;19;57,141564;10,224039;1873;1974;101
1884;33;56,407535;9,820916;1874;1886;12
1884;36;55,306751;12,199669;1869;1924;55
1884;44;57,471613;10,410374;1875;1919;44
1884;55;55,242371;10,53961;1866;2021;155
1884;58;55,754371;12,544068;1884;1899;15
1884;66;54,790388;11,944494;1878;1937;59
1884;67;54,7584557;11,7799705;1877;1905;28
1884;70;55,299963;9,620241;1869;1890;21
1884;73;55,84433;9,589121;1848;2021;173
1884;75;55,731027;9,833955;1866;1939;73
1884;81;56,133911;9,056668;1867;1884;17
1884;96;55,610496;11,586514;1873;1917;44
1884;110;55,965642;9,717756;1884;2006;122
1884;126;57,16496;9,729678;1877;1951;74
1884;128;55,512352;11,287189;1866;1930;64
1884;139;55,430432;9,31255;1884;1888;4
1884;142;55,7217;12,543237;1872;1913;41
1884;143;55,707689;12,555774;1856;1890;34
1884;145;55,682456;12,569828;1877;2021;144
1884;151;54,861238;10,73061;1867;1978;111
1884;166;56,76116;10,187328;1870;1887;17
1884;176;55,460727;9,822756;1880;1960;80
1884;177;56,839448;8,717907;1864;1946;82
1884;182;56,453059;10,866897;1868;1938;70
1884;188;55,513946;10,178703;1882;1938;56
1884;200;55,365817;10,394151;1862;1886;24
1884;209;56,633723;10,219662;1884;1914;30
1884;216;55,850528;8,7593;1878;1891;13
1884;231;56,207889;9,466901;1868;1889;21
1884;234;56,026435;9,863179;1877;1887;10
1884;241;56,651494;8,934794;1855;1908;53
1884;242;56,673252;9,014768;1884;1921;37
1884;257;55,074867;10,467835;1882;1953;71
1884;260;55,110103;10,734595;1867;1930;63
1884;268;56,327852;10,394815;1869;1919;50
1884;294;55,471013;9,099652;1865;2021;156
1884;296;55,369252;9,052748;1844;1885;41
1884;306;55,653994;9,302369;1869;1891;22
1884;308;55,671645;9,5777;1867;1939;72
1884;310;56,956521;9,435052;1873;1887;14
1884;315;56,552152;9,40118;1868;2021;153
1884;321;54,9909127;12,4546417;1883;1891;8
1884;322;54,9748134;12,2737822;1866;2021;155
1884;330;56,92528;10,018117;1866;1908;42
1884;336;56,032176;10,125522;1869;2005;136
1884;341;56,262495;10,268877;1875;1920;45
1884;345;56,125512;10,059451;1879;1888;9
1884;346;56,067076;10,134812;1866;2021;155
1884;13;55,18902;14,96054;1867;2021;154
1884;29;56,328077;10,04661;1876;2021;145
1884;41;55,67571;12,54451;1880;1889;9
1884;47;55,82879;12,15363;1880;1917;37
1884;71;55,98048;12,02986;1864;1892;28
1884;103;56,27039;8,28711;1853;1894;41
1884;153;56,52478;8,20986;1882;1888;6
1884;157;54,83432;11,32731;1867;1887;20
1884;191;55,1839;11,98427;1867;1947;80
1884;192;55,28643;11,55841;1852;1916;64
1884;193;55,94243;10,2267;1883;1889;6
1884;201;55,45808;10,37744;1859;1893;34
1884;202;55,39817;10,3966;1879;1920;41
1884;208;55,74166;11,41925;1865;2021;156
1884;212;56,51632;10,2095;1880;1917;37
1884;235;56,14912;9,91448;1868;1939;71
1884;246;55,28276;11,38655;1884;1886;2
1884;264;56,19409;10,67727;1874;1890;16
1884;287;55,01055;8,77735;1879;1884;5
1884;288;55,61916;12,62803;1884;1894;10
1884;290;55,62305;8,36912;1869;1918;49
1884;304;55,72746;9,53248;1879;1942;63
1884;311;56,37581;9,39626;1877;1895;18
1884;334;57,00195;9,7455;1872;1885;13
1884;349;56,12853;10,16653;1857;1899;42
1885;6;55,269626;10,11524;1877;2009;132
1885;15;57,2642721;9,9501182;1868;1904;36
1885;18;57,320114;9,869439;1872;1890;18
1885;19;57,141564;10,224039;1873;1974;101
1885;33;56,407535;9,820916;1874;1886;12
1885;36;55,306751;12,199669;1869;1924;55
1885;44;57,471613;10,410374;1875;1919;44
1885;55;55,242371;10,53961;1866;2021;155
1885;58;55,754371;12,544068;1884;1899;15
1885;66;54,790388;11,944494;1878;1937;59
1885;67;54,7584557;11,7799705;1877;1905;28
1885;70;55,299963;9,620241;1869;1890;21
1885;73;55,84433;9,589121;1848;2021;173
1885;75;55,731027;9,833955;1866;1939;73
1885;96;55,610496;11,586514;1873;1917;44
1885;110;55,965642;9,717756;1884;2006;122
1885;126;57,16496;9,729678;1877;1951;74
1885;128;55,512352;11,287189;1866;1930;64
1885;139;55,430432;9,31255;1884;1888;4
1885;142;55,7217;12,543237;1872;1913;41
1885;143;55,707689;12,555774;1856;1890;34
1885;145;55,682456;12,569828;1877;2021;144
1885;151;54,861238;10,73061;1867;1978;111
1885;166;56,76116;10,187328;1870;1887;17
1885;176;55,460727;9,822756;1880;1960;80
1885;177;56,839448;8,717907;1864;1946;82
1885;182;56,453059;10,866897;1868;1938;70
1885;188;55,513946;10,178703;1882;1938;56
1885;200;55,365817;10,394151;1862;1886;24
1885;209;56,633723;10,219662;1884;1914;30
1885;213;56,833601;10,113311;1885;1939;54
1885;216;55,850528;8,7593;1878;1891;13
1885;231;56,207889;9,466901;1868;1889;21
1885;234;56,026435;9,863179;1877;1887;10
1885;241;56,651494;8,934794;1855;1908;53
1885;242;56,673252;9,014768;1884;1921;37
1885;257;55,074867;10,467835;1882;1953;71
1885;260;55,110103;10,734595;1867;1930;63
1885;268;56,327852;10,394815;1869;1919;50
1885;294;55,471013;9,099652;1865;2021;156
1885;296;55,369252;9,052748;1844;1885;41
1885;306;55,653994;9,302369;1869;1891;22
1885;308;55,671645;9,5777;1867;1939;72
1885;310;56,956521;9,435052;1873;1887;14
1885;315;56,552152;9,40118;1868;2021;153
1885;321;54,9909127;12,4546417;1883;1891;8
1885;322;54,9748134;12,2737822;1866;2021;155
1885;330;56,92528;10,018117;1866;1908;42
1885;336;56,032176;10,125522;1869;2005;136
1885;341;56,262495;10,268877;1875;1920;45
1885;345;56,125512;10,059451;1879;1888;9
1885;346;56,067076;10,134812;1866;2021;155
1885;13;55,18902;14,96054;1867;2021;154
1885;29;56,328077;10,04661;1876;2021;145
1885;41;55,67571;12,54451;1880;1889;9
1885;47;55,82879;12,15363;1880;1917;37
1885;71;55,98048;12,02986;1864;1892;28
1885;103;56,27039;8,28711;1853;1894;41
1885;153;56,52478;8,20986;1882;1888;6
1885;157;54,83432;11,32731;1867;1887;20
1885;191;55,1839;11,98427;1867;1947;80
1885;192;55,28643;11,55841;1852;1916;64
1885;193;55,94243;10,2267;1883;1889;6
1885;201;55,45808;10,37744;1859;1893;34
1885;202;55,39817;10,3966;1879;1920;41
1885;208;55,74166;11,41925;1865;2021;156
1885;212;56,51632;10,2095;1880;1917;37
1885;235;56,14912;9,91448;1868;1939;71
1885;246;55,28276;11,38655;1884;1886;2
1885;264;56,19409;10,67727;1874;1890;16
1885;288;55,61916;12,62803;1884;1894;10
1885;290;55,62305;8,36912;1869;1918;49
1885;304;55,72746;9,53248;1879;1942;63
1885;311;56,37581;9,39626;1877;1895;18
1885;334;57,00195;9,7455;1872;1885;13
1885;349;56,12853;10,16653;1857;1899;42
1886;6;55,269626;10,11524;1877;2009;132
1886;9;55,3772005;10,0466481;1886;1899;13
1886;15;57,2642721;9,9501182;1868;1904;36
1886;18;57,320114;9,869439;1872;1890;18
1886;19;57,141564;10,224039;1873;1974;101
1886;33;56,407535;9,820916;1874;1886;12
1886;36;55,306751;12,199669;1869;1924;55
1886;44;57,471613;10,410374;1875;1919;44
1886;55;55,242371;10,53961;1866;2021;155
1886;58;55,754371;12,544068;1884;1899;15
1886;66;54,790388;11,944494;1878;1937;59
1886;67;54,7584557;11,7799705;1877;1905;28
1886;70;55,299963;9,620241;1869;1890;21
1886;73;55,84433;9,589121;1848;2021;173
1886;75;55,731027;9,833955;1866;1939;73
1886;96;55,610496;11,586514;1873;1917;44
1886;110;55,965642;9,717756;1884;2006;122
1886;126;57,16496;9,729678;1877;1951;74
1886;128;55,512352;11,287189;1866;1930;64
1886;139;55,430432;9,31255;1884;1888;4
1886;142;55,7217;12,543237;1872;1913;41
1886;143;55,707689;12,555774;1856;1890;34
1886;145;55,682456;12,569828;1877;2021;144
1886;151;54,861238;10,73061;1867;1978;111
1886;166;56,76116;10,187328;1870;1887;17
1886;176;55,460727;9,822756;1880;1960;80
1886;177;56,839448;8,717907;1864;1946;82
1886;182;56,453059;10,866897;1868;1938;70
1886;188;55,513946;10,178703;1882;1938;56
1886;200;55,365817;10,394151;1862;1886;24
1886;209;56,633723;10,219662;1884;1914;30
1886;213;56,833601;10,113311;1885;1939;54
1886;215;56,886164;9,836899;1886;2009;123
1886;216;55,850528;8,7593;1878;1891;13
1886;231;56,207889;9,466901;1868;1889;21
1886;234;56,026435;9,863179;1877;1887;10
1886;241;56,651494;8,934794;1855;1908;53
1886;242;56,673252;9,014768;1884;1921;37
1886;257;55,074867;10,467835;1882;1953;71
1886;260;55,110103;10,734595;1867;1930;63
1886;268;56,327852;10,394815;1869;1919;50
1886;294;55,471013;9,099652;1865;2021;156
1886;306;55,653994;9,302369;1869;1891;22
1886;308;55,671645;9,5777;1867;1939;72
1886;310;56,956521;9,435052;1873;1887;14
1886;315;56,552152;9,40118;1868;2021;153
1886;321;54,9909127;12,4546417;1883;1891;8
1886;322;54,9748134;12,2737822;1866;2021;155
1886;330;56,92528;10,018117;1866;1908;42
1886;336;56,032176;10,125522;1869;2005;136
1886;341;56,262495;10,268877;1875;1920;45
1886;345;56,125512;10,059451;1879;1888;9
1886;346;56,067076;10,134812;1866;2021;155
1886;13;55,18902;14,96054;1867;2021;154
1886;29;56,328077;10,04661;1876;2021;145
1886;41;55,67571;12,54451;1880;1889;9
1886;47;55,82879;12,15363;1880;1917;37
1886;71;55,98048;12,02986;1864;1892;28
1886;103;56,27039;8,28711;1853;1894;41
1886;153;56,52478;8,20986;1882;1888;6
1886;157;54,83432;11,32731;1867;1887;20
1886;191;55,1839;11,98427;1867;1947;80
1886;192;55,28643;11,55841;1852;1916;64
1886;193;55,94243;10,2267;1883;1889;6
1886;201;55,45808;10,37744;1859;1893;34
1886;202;55,39817;10,3966;1879;1920;41
1886;208;55,74166;11,41925;1865;2021;156
1886;212;56,51632;10,2095;1880;1917;37
1886;235;56,14912;9,91448;1868;1939;71
1886;246;55,28276;11,38655;1884;1886;2
1886;264;56,19409;10,67727;1874;1890;16
1886;288;55,61916;12,62803;1884;1894;10
1886;290;55,62305;8,36912;1869;1918;49
1886;304;55,72746;9,53248;1879;1942;63
1886;311;56,37581;9,39626;1877;1895;18
1886;349;56,12853;10,16653;1857;1899;42
1887;6;55,269626;10,11524;1877;2009;132
1887;9;55,3772005;10,0466481;1886;1899;13
1887;15;57,2642721;9,9501182;1868;1904;36
1887;18;57,320114;9,869439;1872;1890;18
1887;19;57,141564;10,224039;1873;1974;101
1887;36;55,306751;12,199669;1869;1924;55
1887;44;57,471613;10,410374;1875;1919;44
1887;55;55,242371;10,53961;1866;2021;155
1887;58;55,754371;12,544068;1884;1899;15
1887;66;54,790388;11,944494;1878;1937;59
1887;67;54,7584557;11,7799705;1877;1905;28
1887;70;55,299963;9,620241;1869;1890;21
1887;73;55,84433;9,589121;1848;2021;173
1887;75;55,731027;9,833955;1866;1939;73
1887;96;55,610496;11,586514;1873;1917;44
1887;110;55,965642;9,717756;1884;2006;122
1887;126;57,16496;9,729678;1877;1951;74
1887;128;55,512352;11,287189;1866;1930;64
1887;139;55,430432;9,31255;1884;1888;4
1887;142;55,7217;12,543237;1872;1913;41
1887;143;55,707689;12,555774;1856;1890;34
1887;145;55,682456;12,569828;1877;2021;144
1887;151;54,861238;10,73061;1867;1978;111
1887;155;56,557877;8,412895;1887;1976;89
1887;166;56,76116;10,187328;1870;1887;17
1887;176;55,460727;9,822756;1880;1960;80
1887;177;56,839448;8,717907;1864;1946;82
1887;182;56,453059;10,866897;1868;1938;70
1887;188;55,513946;10,178703;1882;1938;56
1887;209;56,633723;10,219662;1884;1914;30
1887;213;56,833601;10,113311;1885;1939;54
1887;215;56,886164;9,836899;1886;2009;123
1887;216;55,850528;8,7593;1878;1891;13
1887;231;56,207889;9,466901;1868;1889;21
1887;234;56,026435;9,863179;1877;1887;10
1887;241;56,651494;8,934794;1855;1908;53
1887;242;56,673252;9,014768;1884;1921;37
1887;257;55,074867;10,467835;1882;1953;71
1887;260;55,110103;10,734595;1867;1930;63
1887;268;56,327852;10,394815;1869;1919;50
1887;294;55,471013;9,099652;1865;2021;156
1887;306;55,653994;9,302369;1869;1891;22
1887;308;55,671645;9,5777;1867;1939;72
1887;310;56,956521;9,435052;1873;1887;14
1887;315;56,552152;9,40118;1868;2021;153
1887;321;54,9909127;12,4546417;1883;1891;8
1887;322;54,9748134;12,2737822;1866;2021;155
1887;330;56,92528;10,018117;1866;1908;42
1887;336;56,032176;10,125522;1869;2005;136
1887;341;56,262495;10,268877;1875;1920;45
1887;345;56,125512;10,059451;1879;1888;9
1887;346;56,067076;10,134812;1866;2021;155
1887;13;55,18902;14,96054;1867;2021;154
1887;29;56,328077;10,04661;1876;2021;145
1887;41;55,67571;12,54451;1880;1889;9
1887;47;55,82879;12,15363;1880;1917;37
1887;71;55,98048;12,02986;1864;1892;28
1887;103;56,27039;8,28711;1853;1894;41
1887;153;56,52478;8,20986;1882;1888;6
1887;157;54,83432;11,32731;1867;1887;20
1887;191;55,1839;11,98427;1867;1947;80
1887;192;55,28643;11,55841;1852;1916;64
1887;193;55,94243;10,2267;1883;1889;6
1887;201;55,45808;10,37744;1859;1893;34
1887;202;55,39817;10,3966;1879;1920;41
1887;208;55,74166;11,41925;1865;2021;156
1887;212;56,51632;10,2095;1880;1917;37
1887;235;56,14912;9,91448;1868;1939;71
1887;264;56,19409;10,67727;1874;1890;16
1887;288;55,61916;12,62803;1884;1894;10
1887;290;55,62305;8,36912;1869;1918;49
1887;304;55,72746;9,53248;1879;1942;63
1887;311;56,37581;9,39626;1877;1895;18
1887;349;56,12853;10,16653;1857;1899;42
1888;6;55,269626;10,11524;1877;2009;132
1888;9;55,3772005;10,0466481;1886;1899;13
1888;15;57,2642721;9,9501182;1868;1904;36
1888;18;57,320114;9,869439;1872;1890;18
1888;19;57,141564;10,224039;1873;1974;101
1888;36;55,306751;12,199669;1869;1924;55
1888;44;57,471613;10,410374;1875;1919;44
1888;55;55,242371;10,53961;1866;2021;155
1888;58;55,754371;12,544068;1884;1899;15
1888;66;54,790388;11,944494;1878;1937;59
1888;67;54,7584557;11,7799705;1877;1905;28
1888;70;55,299963;9,620241;1869;1890;21
1888;73;55,84433;9,589121;1848;2021;173
1888;75;55,731027;9,833955;1866;1939;73
1888;96;55,610496;11,586514;1873;1917;44
1888;110;55,965642;9,717756;1884;2006;122
1888;126;57,16496;9,729678;1877;1951;74
1888;128;55,512352;11,287189;1866;1930;64
1888;139;55,430432;9,31255;1884;1888;4
1888;142;55,7217;12,543237;1872;1913;41
1888;143;55,707689;12,555774;1856;1890;34
1888;145;55,682456;12,569828;1877;2021;144
1888;151;54,861238;10,73061;1867;1978;111
1888;155;56,557877;8,412895;1887;1976;89
1888;176;55,460727;9,822756;1880;1960;80
1888;177;56,839448;8,717907;1864;1946;82
1888;182;56,453059;10,866897;1868;1938;70
1888;188;55,513946;10,178703;1882;1938;56
1888;209;56,633723;10,219662;1884;1914;30
1888;213;56,833601;10,113311;1885;1939;54
1888;215;56,886164;9,836899;1886;2009;123
1888;216;55,850528;8,7593;1878;1891;13
1888;231;56,207889;9,466901;1868;1889;21
1888;241;56,651494;8,934794;1855;1908;53
1888;242;56,673252;9,014768;1884;1921;37
1888;257;55,074867;10,467835;1882;1953;71
1888;260;55,110103;10,734595;1867;1930;63
1888;268;56,327852;10,394815;1869;1919;50
1888;294;55,471013;9,099652;1865;2021;156
1888;306;55,653994;9,302369;1869;1891;22
1888;308;55,671645;9,5777;1867;1939;72
1888;315;56,552152;9,40118;1868;2021;153
1888;321;54,9909127;12,4546417;1883;1891;8
1888;322;54,9748134;12,2737822;1866;2021;155
1888;330;56,92528;10,018117;1866;1908;42
1888;336;56,032176;10,125522;1869;2005;136
1888;341;56,262495;10,268877;1875;1920;45
1888;345;56,125512;10,059451;1879;1888;9
1888;346;56,067076;10,134812;1866;2021;155
1888;13;55,18902;14,96054;1867;2021;154
1888;29;56,328077;10,04661;1876;2021;145
1888;41;55,67571;12,54451;1880;1889;9
1888;47;55,82879;12,15363;1880;1917;37
1888;71;55,98048;12,02986;1864;1892;28
1888;103;56,27039;8,28711;1853;1894;41
1888;153;56,52478;8,20986;1882;1888;6
1888;191;55,1839;11,98427;1867;1947;80
1888;192;55,28643;11,55841;1852;1916;64
1888;193;55,94243;10,2267;1883;1889;6
1888;201;55,45808;10,37744;1859;1893;34
1888;202;55,39817;10,3966;1879;1920;41
1888;208;55,74166;11,41925;1865;2021;156
1888;212;56,51632;10,2095;1880;1917;37
1888;235;56,14912;9,91448;1868;1939;71
1888;264;56,19409;10,67727;1874;1890;16
1888;288;55,61916;12,62803;1884;1894;10
1888;290;55,62305;8,36912;1869;1918;49
1888;304;55,72746;9,53248;1879;1942;63
1888;311;56,37581;9,39626;1877;1895;18
1888;349;56,12853;10,16653;1857;1899;42
1889;6;55,269626;10,11524;1877;2009;132
1889;9;55,3772005;10,0466481;1886;1899;13
1889;15;57,2642721;9,9501182;1868;1904;36
1889;18;57,320114;9,869439;1872;1890;18
1889;19;57,141564;10,224039;1873;1974;101
1889;36;55,306751;12,199669;1869;1924;55
1889;44;57,471613;10,410374;1875;1919;44
1889;55;55,242371;10,53961;1866;2021;155
1889;58;55,754371;12,544068;1884;1899;15
1889;66;54,790388;11,944494;1878;1937;59
1889;67;54,7584557;11,7799705;1877;1905;28
1889;70;55,299963;9,620241;1869;1890;21
1889;73;55,84433;9,589121;1848;2021;173
1889;75;55,731027;9,833955;1866;1939;73
1889;96;55,610496;11,586514;1873;1917;44
1889;110;55,965642;9,717756;1884;2006;122
1889;126;57,16496;9,729678;1877;1951;74
1889;128;55,512352;11,287189;1866;1930;64
1889;142;55,7217;12,543237;1872;1913;41
1889;143;55,707689;12,555774;1856;1890;34
1889;145;55,682456;12,569828;1877;2021;144
1889;151;54,861238;10,73061;1867;1978;111
1889;155;56,557877;8,412895;1887;1976;89
1889;176;55,460727;9,822756;1880;1960;80
1889;177;56,839448;8,717907;1864;1946;82
1889;182;56,453059;10,866897;1868;1938;70
1889;188;55,513946;10,178703;1882;1938;56
1889;209;56,633723;10,219662;1884;1914;30
1889;213;56,833601;10,113311;1885;1939;54
1889;215;56,886164;9,836899;1886;2009;123
1889;216;55,850528;8,7593;1878;1891;13
1889;231;56,207889;9,466901;1868;1889;21
1889;241;56,651494;8,934794;1855;1908;53
1889;242;56,673252;9,014768;1884;1921;37
1889;251;55,4226556;11,5675895;1889;1927;38
1889;257;55,074867;10,467835;1882;1953;71
1889;260;55,110103;10,734595;1867;1930;63
1889;268;56,327852;10,394815;1869;1919;50
1889;294;55,471013;9,099652;1865;2021;156
1889;301;55,643464;9,651961;1889;2021;132
1889;306;55,653994;9,302369;1869;1891;22
1889;308;55,671645;9,5777;1867;1939;72
1889;315;56,552152;9,40118;1868;2021;153
1889;321;54,9909127;12,4546417;1883;1891;8
1889;322;54,9748134;12,2737822;1866;2021;155
1889;330;56,92528;10,018117;1866;1908;42
1889;336;56,032176;10,125522;1869;2005;136
1889;341;56,262495;10,268877;1875;1920;45
1889;346;56,067076;10,134812;1866;2021;155
1889;13;55,18902;14,96054;1867;2021;154
1889;29;56,328077;10,04661;1876;2021;145
1889;41;55,67571;12,54451;1880;1889;9
1889;47;55,82879;12,15363;1880;1917;37
1889;52;55,14476;10,34458;1889;1905;16
1889;71;55,98048;12,02986;1864;1892;28
1889;103;56,27039;8,28711;1853;1894;41
1889;191;55,1839;11,98427;1867;1947;80
1889;192;55,28643;11,55841;1852;1916;64
1889;193;55,94243;10,2267;1883;1889;6
1889;201;55,45808;10,37744;1859;1893;34
1889;202;55,39817;10,3966;1879;1920;41
1889;208;55,74166;11,41925;1865;2021;156
1889;212;56,51632;10,2095;1880;1917;37
1889;235;56,14912;9,91448;1868;1939;71
1889;259;55,06429;10,59102;1889;1910;21
1889;264;56,19409;10,67727;1874;1890;16
1889;288;55,61916;12,62803;1884;1894;10
1889;290;55,62305;8,36912;1869;1918;49
1889;304;55,72746;9,53248;1879;1942;63
1889;311;56,37581;9,39626;1877;1895;18
1889;349;56,12853;10,16653;1857;1899;42
1890;6;55,269626;10,11524;1877;2009;132
1890;9;55,3772005;10,0466481;1886;1899;13
1890;15;57,2642721;9,9501182;1868;1904;36
1890;18;57,320114;9,869439;1872;1890;18
1890;19;57,141564;10,224039;1873;1974;101
1890;36;55,306751;12,199669;1869;1924;55
1890;44;57,471613;10,410374;1875;1919;44
1890;55;55,242371;10,53961;1866;2021;155
1890;58;55,754371;12,544068;1884;1899;15
1890;66;54,790388;11,944494;1878;1937;59
1890;67;54,7584557;11,7799705;1877;1905;28
1890;70;55,299963;9,620241;1869;1890;21
1890;73;55,84433;9,589121;1848;2021;173
1890;75;55,731027;9,833955;1866;1939;73
1890;93;57,356497;9,936222;1890;2021;131
1890;96;55,610496;11,586514;1873;1917;44
1890;110;55,965642;9,717756;1884;2006;122
1890;126;57,16496;9,729678;1877;1951;74
1890;128;55,512352;11,287189;1866;1930;64
1890;142;55,7217;12,543237;1872;1913;41
1890;143;55,707689;12,555774;1856;1890;34
1890;145;55,682456;12,569828;1877;2021;144
1890;151;54,861238;10,73061;1867;1978;111
1890;155;56,557877;8,412895;1887;1976;89
1890;160;55,78677;12,495101;1890;1937;47
1890;176;55,460727;9,822756;1880;1960;80
1890;177;56,839448;8,717907;1864;1946;82
1890;182;56,453059;10,866897;1868;1938;70
1890;188;55,513946;10,178703;1882;1938;56
1890;195;55,9775064;10,1756177;1890;2021;131
1890;209;56,633723;10,219662;1884;1914;30
1890;213;56,833601;10,113311;1885;1939;54
1890;215;56,886164;9,836899;1886;2009;123
1890;216;55,850528;8,7593;1878;1891;13
1890;241;56,651494;8,934794;1855;1908;53
1890;242;56,673252;9,014768;1884;1921;37
1890;251;55,4226556;11,5675895;1889;1927;38
1890;257;55,074867;10,467835;1882;1953;71
1890;260;55,110103;10,734595;1867;1930;63
1890;268;56,327852;10,394815;1869;1919;50
1890;294;55,471013;9,099652;1865;2021;156
1890;301;55,643464;9,651961;1889;2021;132
1890;306;55,653994;9,302369;1869;1891;22
1890;308;55,671645;9,5777;1867;1939;72
1890;315;56,552152;9,40118;1868;2021;153
1890;321;54,9909127;12,4546417;1883;1891;8
1890;322;54,9748134;12,2737822;1866;2021;155
1890;330;56,92528;10,018117;1866;1908;42
1890;336;56,032176;10,125522;1869;2005;136
1890;341;56,262495;10,268877;1875;1920;45
1890;346;56,067076;10,134812;1866;2021;155
1890;13;55,18902;14,96054;1867;2021;154
1890;29;56,328077;10,04661;1876;2021;145
1890;47;55,82879;12,15363;1880;1917;37
1890;52;55,14476;10,34458;1889;1905;16
1890;71;55,98048;12,02986;1864;1892;28
1890;103;56,27039;8,28711;1853;1894;41
1890;191;55,1839;11,98427;1867;1947;80
1890;192;55,28643;11,55841;1852;1916;64
1890;201;55,45808;10,37744;1859;1893;34
1890;202;55,39817;10,3966;1879;1920;41
1890;208;55,74166;11,41925;1865;2021;156
1890;212;56,51632;10,2095;1880;1917;37
1890;235;56,14912;9,91448;1868;1939;71
1890;259;55,06429;10,59102;1889;1910;21
1890;264;56,19409;10,67727;1874;1890;16
1890;288;55,61916;12,62803;1884;1894;10
1890;290;55,62305;8,36912;1869;1918;49
1890;304;55,72746;9,53248;1879;1942;63
1890;311;56,37581;9,39626;1877;1895;18
1890;349;56,12853;10,16653;1857;1899;42
1891;6;55,269626;10,11524;1877;2009;132
1891;9;55,3772005;10,0466481;1886;1899;13
1891;15;57,2642721;9,9501182;1868;1904;36
1891;19;57,141564;10,224039;1873;1974;101
1891;34;55,3214857;11,9687601;1891;1987;96
1891;36;55,306751;12,199669;1869;1924;55
1891;44;57,471613;10,410374;1875;1919;44
1891;55;55,242371;10,53961;1866;2021;155
1891;58;55,754371;12,544068;1884;1899;15
1891;65;54,6656231;11,7384629;1891;1902;11
1891;66;54,790388;11,944494;1878;1937;59
1891;67;54,7584557;11,7799705;1877;1905;28
1891;73;55,84433;9,589121;1848;2021;173
1891;75;55,731027;9,833955;1866;1939;73
1891;90;57,562284;9,986481;1891;1967;76
1891;93;57,356497;9,936222;1890;2021;131
1891;96;55,610496;11,586514;1873;1917;44
1891;110;55,965642;9,717756;1884;2006;122
1891;126;57,16496;9,729678;1877;1951;74
1891;128;55,512352;11,287189;1866;1930;64
1891;142;55,7217;12,543237;1872;1913;41
1891;144;55,673798;12,577517;1891;2021;130
1891;145;55,682456;12,569828;1877;2021;144
1891;151;54,861238;10,73061;1867;1978;111
1891;155;56,557877;8,412895;1887;1976;89
1891;160;55,78677;12,495101;1890;1937;47
1891;176;55,460727;9,822756;1880;1960;80
1891;177;56,839448;8,717907;1864;1946;82
1891;182;56,453059;10,866897;1868;1938;70
1891;188;55,513946;10,178703;1882;1938;56
1891;195;55,9775064;10,1756177;1890;2021;131
1891;209;56,633723;10,219662;1884;1914;30
1891;213;56,833601;10,113311;1885;1939;54
1891;215;56,886164;9,836899;1886;2009;123
1891;216;55,850528;8,7593;1878;1891;13
1891;241;56,651494;8,934794;1855;1908;53
1891;242;56,673252;9,014768;1884;1921;37
1891;251;55,4226556;11,5675895;1889;1927;38
1891;257;55,074867;10,467835;1882;1953;71
1891;260;55,110103;10,734595;1867;1930;63
1891;268;56,327852;10,394815;1869;1919;50
1891;294;55,471013;9,099652;1865;2021;156
1891;301;55,643464;9,651961;1889;2021;132
1891;306;55,653994;9,302369;1869;1891;22
1891;308;55,671645;9,5777;1867;1939;72
1891;315;56,552152;9,40118;1868;2021;153
1891;321;54,9909127;12,4546417;1883;1891;8
1891;322;54,9748134;12,2737822;1866;2021;155
1891;330;56,92528;10,018117;1866;1908;42
1891;336;56,032176;10,125522;1869;2005;136
1891;341;56,262495;10,268877;1875;1920;45
1891;346;56,067076;10,134812;1866;2021;155
1891;13;55,18902;14,96054;1867;2021;154
1891;29;56,328077;10,04661;1876;2021;145
1891;47;55,82879;12,15363;1880;1917;37
1891;52;55,14476;10,34458;1889;1905;16
1891;71;55,98048;12,02986;1864;1892;28
1891;103;56,27039;8,28711;1853;1894;41
1891;146;55,68421;12,5715;1891;1893;2
1891;191;55,1839;11,98427;1867;1947;80
1891;192;55,28643;11,55841;1852;1916;64
1891;201;55,45808;10,37744;1859;1893;34
1891;202;55,39817;10,3966;1879;1920;41
1891;208;55,74166;11,41925;1865;2021;156
1891;212;56,51632;10,2095;1880;1917;37
1891;235;56,14912;9,91448;1868;1939;71
1891;259;55,06429;10,59102;1889;1910;21
1891;288;55,61916;12,62803;1884;1894;10
1891;290;55,62305;8,36912;1869;1918;49
1891;304;55,72746;9,53248;1879;1942;63
1891;311;56,37581;9,39626;1877;1895;18
1891;332;56,94134;10,01256;1891;1899;8
1891;349;56,12853;10,16653;1857;1899;42
1892;6;55,269626;10,11524;1877;2009;132
1892;9;55,3772005;10,0466481;1886;1899;13
1892;15;57,2642721;9,9501182;1868;1904;36
1892;19;57,141564;10,224039;1873;1974;101
1892;34;55,3214857;11,9687601;1891;1987;96
1892;36;55,306751;12,199669;1869;1924;55
1892;44;57,471613;10,410374;1875;1919;44
1892;55;55,242371;10,53961;1866;2021;155
1892;58;55,754371;12,544068;1884;1899;15
1892;65;54,6656231;11,7384629;1891;1902;11
1892;66;54,790388;11,944494;1878;1937;59
1892;67;54,7584557;11,7799705;1877;1905;28
1892;73;55,84433;9,589121;1848;2021;173
1892;75;55,731027;9,833955;1866;1939;73
1892;90;57,562284;9,986481;1891;1967;76
1892;93;57,356497;9,936222;1890;2021;131
1892;96;55,610496;11,586514;1873;1917;44
1892;110;55,965642;9,717756;1884;2006;122
1892;126;57,16496;9,729678;1877;1951;74
1892;128;55,512352;11,287189;1866;1930;64
1892;142;55,7217;12,543237;1872;1913;41
1892;144;55,673798;12,577517;1891;2021;130
1892;145;55,682456;12,569828;1877;2021;144
1892;151;54,861238;10,73061;1867;1978;111
1892;155;56,557877;8,412895;1887;1976;89
1892;160;55,78677;12,495101;1890;1937;47
1892;175;55,43019;9,871348;1892;1901;9
1892;176;55,460727;9,822756;1880;1960;80
1892;177;56,839448;8,717907;1864;1946;82
1892;182;56,453059;10,866897;1868;1938;70
1892;188;55,513946;10,178703;1882;1938;56
1892;195;55,9775064;10,1756177;1890;2021;131
1892;209;56,633723;10,219662;1884;1914;30
1892;213;56,833601;10,113311;1885;1939;54
1892;215;56,886164;9,836899;1886;2009;123
1892;236;56,090396;9,758625;1892;2021;129
1892;241;56,651494;8,934794;1855;1908;53
1892;242;56,673252;9,014768;1884;1921;37
1892;251;55,4226556;11,5675895;1889;1927;38
1892;257;55,074867;10,467835;1882;1953;71
1892;260;55,110103;10,734595;1867;1930;63
1892;268;56,327852;10,394815;1869;1919;50
1892;294;55,471013;9,099652;1865;2021;156
1892;301;55,643464;9,651961;1889;2021;132
1892;308;55,671645;9,5777;1867;1939;72
1892;315;56,552152;9,40118;1868;2021;153
1892;322;54,9748134;12,2737822;1866;2021;155
1892;330;56,92528;10,018117;1866;1908;42
1892;336;56,032176;10,125522;1869;2005;136
1892;341;56,262495;10,268877;1875;1920;45
1892;346;56,067076;10,134812;1866;2021;155
1892;13;55,18902;14,96054;1867;2021;154
1892;29;56,328077;10,04661;1876;2021;145
1892;47;55,82879;12,15363;1880;1917;37
1892;52;55,14476;10,34458;1889;1905;16
1892;71;55,98048;12,02986;1864;1892;28
1892;103;56,27039;8,28711;1853;1894;41
1892;146;55,68421;12,5715;1891;1893;2
1892;191;55,1839;11,98427;1867;1947;80
1892;192;55,28643;11,55841;1852;1916;64
1892;201;55,45808;10,37744;1859;1893;34
1892;202;55,39817;10,3966;1879;1920;41
1892;208;55,74166;11,41925;1865;2021;156
1892;212;56,51632;10,2095;1880;1917;37
1892;235;56,14912;9,91448;1868;1939;71
1892;259;55,06429;10,59102;1889;1910;21
1892;288;55,61916;12,62803;1884;1894;10
1892;290;55,62305;8,36912;1869;1918;49
1892;304;55,72746;9,53248;1879;1942;63
1892;311;56,37581;9,39626;1877;1895;18
1892;332;56,94134;10,01256;1891;1899;8
1892;349;56,12853;10,16653;1857;1899;42
1893;6;55,269626;10,11524;1877;2009;132
1893;9;55,3772005;10,0466481;1886;1899;13
1893;15;57,2642721;9,9501182;1868;1904;36
1893;19;57,141564;10,224039;1873;1974;101
1893;34;55,3214857;11,9687601;1891;1987;96
1893;36;55,306751;12,199669;1869;1924;55
1893;44;57,471613;10,410374;1875;1919;44
1893;55;55,242371;10,53961;1866;2021;155
1893;58;55,754371;12,544068;1884;1899;15
1893;65;54,6656231;11,7384629;1891;1902;11
1893;66;54,790388;11,944494;1878;1937;59
1893;67;54,7584557;11,7799705;1877;1905;28
1893;73;55,84433;9,589121;1848;2021;173
1893;75;55,731027;9,833955;1866;1939;73
1893;90;57,562284;9,986481;1891;1967;76
1893;93;57,356497;9,936222;1890;2021;131
1893;96;55,610496;11,586514;1873;1917;44
1893;110;55,965642;9,717756;1884;2006;122
1893;126;57,16496;9,729678;1877;1951;74
1893;128;55,512352;11,287189;1866;1930;64
1893;142;55,7217;12,543237;1872;1913;41
1893;144;55,673798;12,577517;1891;2021;130
1893;145;55,682456;12,569828;1877;2021;144
1893;151;54,861238;10,73061;1867;1978;111
1893;155;56,557877;8,412895;1887;1976;89
1893;160;55,78677;12,495101;1890;1937;47
1893;175;55,43019;9,871348;1892;1901;9
1893;176;55,460727;9,822756;1880;1960;80
1893;177;56,839448;8,717907;1864;1946;82
1893;182;56,453059;10,866897;1868;1938;70
1893;188;55,513946;10,178703;1882;1938;56
1893;195;55,9775064;10,1756177;1890;2021;131
1893;209;56,633723;10,219662;1884;1914;30
1893;213;56,833601;10,113311;1885;1939;54
1893;215;56,886164;9,836899;1886;2009;123
1893;236;56,090396;9,758625;1892;2021;129
1893;241;56,651494;8,934794;1855;1908;53
1893;242;56,673252;9,014768;1884;1921;37
1893;251;55,4226556;11,5675895;1889;1927;38
1893;257;55,074867;10,467835;1882;1953;71
1893;260;55,110103;10,734595;1867;1930;63
1893;268;56,327852;10,394815;1869;1919;50
1893;294;55,471013;9,099652;1865;2021;156
1893;301;55,643464;9,651961;1889;2021;132
1893;308;55,671645;9,5777;1867;1939;72
1893;315;56,552152;9,40118;1868;2021;153
1893;322;54,9748134;12,2737822;1866;2021;155
1893;330;56,92528;10,018117;1866;1908;42
1893;336;56,032176;10,125522;1869;2005;136
1893;341;56,262495;10,268877;1875;1920;45
1893;346;56,067076;10,134812;1866;2021;155
1893;13;55,18902;14,96054;1867;2021;154
1893;29;56,328077;10,04661;1876;2021;145
1893;47;55,82879;12,15363;1880;1917;37
1893;52;55,14476;10,34458;1889;1905;16
1893;103;56,27039;8,28711;1853;1894;41
1893;146;55,68421;12,5715;1891;1893;2
1893;191;55,1839;11,98427;1867;1947;80
1893;192;55,28643;11,55841;1852;1916;64
1893;201;55,45808;10,37744;1859;1893;34
1893;202;55,39817;10,3966;1879;1920;41
1893;208;55,74166;11,41925;1865;2021;156
1893;212;56,51632;10,2095;1880;1917;37
1893;235;56,14912;9,91448;1868;1939;71
1893;259;55,06429;10,59102;1889;1910;21
1893;288;55,61916;12,62803;1884;1894;10
1893;290;55,62305;8,36912;1869;1918;49
1893;304;55,72746;9,53248;1879;1942;63
1893;311;56,37581;9,39626;1877;1895;18
1893;332;56,94134;10,01256;1891;1899;8
1893;349;56,12853;10,16653;1857;1899;42
1894;6;55,269626;10,11524;1877;2009;132
1894;9;55,3772005;10,0466481;1886;1899;13
1894;15;57,2642721;9,9501182;1868;1904;36
1894;19;57,141564;10,224039;1873;1974;101
1894;34;55,3214857;11,9687601;1891;1987;96
1894;36;55,306751;12,199669;1869;1924;55
1894;44;57,471613;10,410374;1875;1919;44
1894;55;55,242371;10,53961;1866;2021;155
1894;58;55,754371;12,544068;1884;1899;15
1894;65;54,6656231;11,7384629;1891;1902;11
1894;66;54,790388;11,944494;1878;1937;59
1894;67;54,7584557;11,7799705;1877;1905;28
1894;73;55,84433;9,589121;1848;2021;173
1894;75;55,731027;9,833955;1866;1939;73
1894;90;57,562284;9,986481;1891;1967;76
1894;93;57,356497;9,936222;1890;2021;131
1894;96;55,610496;11,586514;1873;1917;44
1894;105;55,92122;9,997713;1894;1923;29
1894;110;55,965642;9,717756;1884;2006;122
1894;126;57,16496;9,729678;1877;1951;74
1894;128;55,512352;11,287189;1866;1930;64
1894;142;55,7217;12,543237;1872;1913;41
1894;144;55,673798;12,577517;1891;2021;130
1894;145;55,682456;12,569828;1877;2021;144
1894;151;54,861238;10,73061;1867;1978;111
1894;155;56,557877;8,412895;1887;1976;89
1894;160;55,78677;12,495101;1890;1937;47
1894;175;55,43019;9,871348;1892;1901;9
1894;176;55,460727;9,822756;1880;1960;80
1894;177;56,839448;8,717907;1864;1946;82
1894;182;56,453059;10,866897;1868;1938;70
1894;188;55,513946;10,178703;1882;1938;56
1894;195;55,9775064;10,1756177;1890;2021;131
1894;209;56,633723;10,219662;1884;1914;30
1894;213;56,833601;10,113311;1885;1939;54
1894;215;56,886164;9,836899;1886;2009;123
1894;236;56,090396;9,758625;1892;2021;129
1894;241;56,651494;8,934794;1855;1908;53
1894;242;56,673252;9,014768;1884;1921;37
1894;251;55,4226556;11,5675895;1889;1927;38
1894;257;55,074867;10,467835;1882;1953;71
1894;260;55,110103;10,734595;1867;1930;63
1894;268;56,327852;10,394815;1869;1919;50
1894;270;56,302138;10,477471;1894;2021;127
1894;294;55,471013;9,099652;1865;2021;156
1894;301;55,643464;9,651961;1889;2021;132
1894;308;55,671645;9,5777;1867;1939;72
1894;315;56,552152;9,40118;1868;2021;153
1894;322;54,9748134;12,2737822;1866;2021;155
1894;330;56,92528;10,018117;1866;1908;42
1894;336;56,032176;10,125522;1869;2005;136
1894;341;56,262495;10,268877;1875;1920;45
1894;346;56,067076;10,134812;1866;2021;155
1894;13;55,18902;14,96054;1867;2021;154
1894;29;56,328077;10,04661;1876;2021;145
1894;47;55,82879;12,15363;1880;1917;37
1894;52;55,14476;10,34458;1889;1905;16
1894;103;56,27039;8,28711;1853;1894;41
1894;191;55,1839;11,98427;1867;1947;80
1894;192;55,28643;11,55841;1852;1916;64
1894;202;55,39817;10,3966;1879;1920;41
1894;208;55,74166;11,41925;1865;2021;156
1894;212;56,51632;10,2095;1880;1917;37
1894;235;56,14912;9,91448;1868;1939;71
1894;252;55,2722;12,32416;1894;1953;59
1894;259;55,06429;10,59102;1889;1910;21
1894;267;56,36213;10,59199;1894;1897;3
1894;288;55,61916;12,62803;1884;1894;10
1894;290;55,62305;8,36912;1869;1918;49
1894;304;55,72746;9,53248;1879;1942;63
1894;311;56,37581;9,39626;1877;1895;18
1894;332;56,94134;10,01256;1891;1899;8
1894;349;56,12853;10,16653;1857;1899;42
1895;6;55,269626;10,11524;1877;2009;132
1895;9;55,3772005;10,0466481;1886;1899;13
1895;15;57,2642721;9,9501182;1868;1904;36
1895;19;57,141564;10,224039;1873;1974;101
1895;34;55,3214857;11,9687601;1891;1987;96
1895;36;55,306751;12,199669;1869;1924;55
1895;44;57,471613;10,410374;1875;1919;44
1895;55;55,242371;10,53961;1866;2021;155
1895;58;55,754371;12,544068;1884;1899;15
1895;65;54,6656231;11,7384629;1891;1902;11
1895;66;54,790388;11,944494;1878;1937;59
1895;67;54,7584557;11,7799705;1877;1905;28
1895;73;55,84433;9,589121;1848;2021;173
1895;75;55,731027;9,833955;1866;1939;73
1895;85;55,941434;12,268503;1895;1937;42
1895;90;57,562284;9,986481;1891;1967;76
1895;93;57,356497;9,936222;1890;2021;131
1895;96;55,610496;11,586514;1873;1917;44
1895;105;55,92122;9,997713;1894;1923;29
1895;110;55,965642;9,717756;1884;2006;122
1895;126;57,16496;9,729678;1877;1951;74
1895;128;55,512352;11,287189;1866;1930;64
1895;142;55,7217;12,543237;1872;1913;41
1895;144;55,673798;12,577517;1891;2021;130
1895;145;55,682456;12,569828;1877;2021;144
1895;151;54,861238;10,73061;1867;1978;111
1895;155;56,557877;8,412895;1887;1976;89
1895;160;55,78677;12,495101;1890;1937;47
1895;175;55,43019;9,871348;1892;1901;9
1895;176;55,460727;9,822756;1880;1960;80
1895;177;56,839448;8,717907;1864;1946;82
1895;182;56,453059;10,866897;1868;1938;70
1895;188;55,513946;10,178703;1882;1938;56
1895;195;55,9775064;10,1756177;1890;2021;131
1895;209;56,633723;10,219662;1884;1914;30
1895;213;56,833601;10,113311;1885;1939;54
1895;215;56,886164;9,836899;1886;2009;123
1895;236;56,090396;9,758625;1892;2021;129
1895;241;56,651494;8,934794;1855;1908;53
1895;242;56,673252;9,014768;1884;1921;37
1895;251;55,4226556;11,5675895;1889;1927;38
1895;257;55,074867;10,467835;1882;1953;71
1895;260;55,110103;10,734595;1867;1930;63
1895;268;56,327852;10,394815;1869;1919;50
1895;270;56,302138;10,477471;1894;2021;127
1895;294;55,471013;9,099652;1865;2021;156
1895;301;55,643464;9,651961;1889;2021;132
1895;308;55,671645;9,5777;1867;1939;72
1895;315;56,552152;9,40118;1868;2021;153
1895;322;54,9748134;12,2737822;1866;2021;155
1895;330;56,92528;10,018117;1866;1908;42
1895;336;56,032176;10,125522;1869;2005;136
1895;340;56,24119;10,199622;1895;1912;17
1895;341;56,262495;10,268877;1875;1920;45
1895;346;56,067076;10,134812;1866;2021;155
1895;13;55,18902;14,96054;1867;2021;154
1895;29;56,328077;10,04661;1876;2021;145
1895;47;55,82879;12,15363;1880;1917;37
1895;52;55,14476;10,34458;1889;1905;16
1895;191;55,1839;11,98427;1867;1947;80
1895;192;55,28643;11,55841;1852;1916;64
1895;202;55,39817;10,3966;1879;1920;41
1895;208;55,74166;11,41925;1865;2021;156
1895;212;56,51632;10,2095;1880;1917;37
1895;235;56,14912;9,91448;1868;1939;71
1895;252;55,2722;12,32416;1894;1953;59
1895;259;55,06429;10,59102;1889;1910;21
1895;267;56,36213;10,59199;1894;1897;3
1895;279;56,93435;8,53381;1895;1913;18
1895;290;55,62305;8,36912;1869;1918;49
1895;304;55,72746;9,53248;1879;1942;63
1895;311;56,37581;9,39626;1877;1895;18
1895;332;56,94134;10,01256;1891;1899;8
1895;349;56,12853;10,16653;1857;1899;42
1896;6;55,269626;10,11524;1877;2009;132
1896;9;55,3772005;10,0466481;1886;1899;13
1896;15;57,2642721;9,9501182;1868;1904;36
1896;19;57,141564;10,224039;1873;1974;101
1896;34;55,3214857;11,9687601;1891;1987;96
1896;36;55,306751;12,199669;1869;1924;55
1896;44;57,471613;10,410374;1875;1919;44
1896;55;55,242371;10,53961;1866;2021;155
1896;58;55,754371;12,544068;1884;1899;15
1896;65;54,6656231;11,7384629;1891;1902;11
1896;66;54,790388;11,944494;1878;1937;59
1896;67;54,7584557;11,7799705;1877;1905;28
1896;73;55,84433;9,589121;1848;2021;173
1896;75;55,731027;9,833955;1866;1939;73
1896;85;55,941434;12,268503;1895;1937;42
1896;90;57,562284;9,986481;1891;1967;76
1896;93;57,356497;9,936222;1890;2021;131
1896;96;55,610496;11,586514;1873;1917;44
1896;105;55,92122;9,997713;1894;1923;29
1896;110;55,965642;9,717756;1884;2006;122
1896;126;57,16496;9,729678;1877;1951;74
1896;128;55,512352;11,287189;1866;1930;64
1896;142;55,7217;12,543237;1872;1913;41
1896;144;55,673798;12,577517;1891;2021;130
1896;145;55,682456;12,569828;1877;2021;144
1896;151;54,861238;10,73061;1867;1978;111
1896;155;56,557877;8,412895;1887;1976;89
1896;160;55,78677;12,495101;1890;1937;47
1896;175;55,43019;9,871348;1892;1901;9
1896;176;55,460727;9,822756;1880;1960;80
1896;177;56,839448;8,717907;1864;1946;82
1896;182;56,453059;10,866897;1868;1938;70
1896;188;55,513946;10,178703;1882;1938;56
1896;195;55,9775064;10,1756177;1890;2021;131
1896;209;56,633723;10,219662;1884;1914;30
1896;213;56,833601;10,113311;1885;1939;54
1896;215;56,886164;9,836899;1886;2009;123
1896;236;56,090396;9,758625;1892;2021;129
1896;241;56,651494;8,934794;1855;1908;53
1896;242;56,673252;9,014768;1884;1921;37
1896;251;55,4226556;11,5675895;1889;1927;38
1896;257;55,074867;10,467835;1882;1953;71
1896;260;55,110103;10,734595;1867;1930;63
1896;268;56,327852;10,394815;1869;1919;50
1896;270;56,302138;10,477471;1894;2021;127
1896;294;55,471013;9,099652;1865;2021;156
1896;301;55,643464;9,651961;1889;2021;132
1896;303;55,84349;9,240195;1896;1905;9
1896;308;55,671645;9,5777;1867;1939;72
1896;315;56,552152;9,40118;1868;2021;153
1896;322;54,9748134;12,2737822;1866;2021;155
1896;330;56,92528;10,018117;1866;1908;42
1896;336;56,032176;10,125522;1869;2005;136
1896;340;56,24119;10,199622;1895;1912;17
1896;341;56,262495;10,268877;1875;1920;45
1896;346;56,067076;10,134812;1866;2021;155
1896;13;55,18902;14,96054;1867;2021;154
1896;29;56,328077;10,04661;1876;2021;145
1896;47;55,82879;12,15363;1880;1917;37
1896;52;55,14476;10,34458;1889;1905;16
1896;191;55,1839;11,98427;1867;1947;80
1896;192;55,28643;11,55841;1852;1916;64
1896;202;55,39817;10,3966;1879;1920;41
1896;208;55,74166;11,41925;1865;2021;156
1896;212;56,51632;10,2095;1880;1917;37
1896;235;56,14912;9,91448;1868;1939;71
1896;252;55,2722;12,32416;1894;1953;59
1896;259;55,06429;10,59102;1889;1910;21
1896;267;56,36213;10,59199;1894;1897;3
1896;279;56,93435;8,53381;1895;1913;18
1896;290;55,62305;8,36912;1869;1918;49
1896;304;55,72746;9,53248;1879;1942;63
1896;332;56,94134;10,01256;1891;1899;8
1896;349;56,12853;10,16653;1857;1899;42
1897;6;55,269626;10,11524;1877;2009;132
1897;9;55,3772005;10,0466481;1886;1899;13
1897;15;57,2642721;9,9501182;1868;1904;36
1897;19;57,141564;10,224039;1873;1974;101
1897;34;55,3214857;11,9687601;1891;1987;96
1897;36;55,306751;12,199669;1869;1924;55
1897;44;57,471613;10,410374;1875;1919;44
1897;55;55,242371;10,53961;1866;2021;155
1897;58;55,754371;12,544068;1884;1899;15
1897;65;54,6656231;11,7384629;1891;1902;11
1897;66;54,790388;11,944494;1878;1937;59
1897;67;54,7584557;11,7799705;1877;1905;28
1897;73;55,84433;9,589121;1848;2021;173
1897;75;55,731027;9,833955;1866;1939;73
1897;85;55,941434;12,268503;1895;1937;42
1897;90;57,562284;9,986481;1891;1967;76
1897;93;57,356497;9,936222;1890;2021;131
1897;96;55,610496;11,586514;1873;1917;44
1897;105;55,92122;9,997713;1894;1923;29
1897;110;55,965642;9,717756;1884;2006;122
1897;126;57,16496;9,729678;1877;1951;74
1897;128;55,512352;11,287189;1866;1930;64
1897;142;55,7217;12,543237;1872;1913;41
1897;144;55,673798;12,577517;1891;2021;130
1897;145;55,682456;12,569828;1877;2021;144
1897;151;54,861238;10,73061;1867;1978;111
1897;155;56,557877;8,412895;1887;1976;89
1897;160;55,78677;12,495101;1890;1937;47
1897;175;55,43019;9,871348;1892;1901;9
1897;176;55,460727;9,822756;1880;1960;80
1897;177;56,839448;8,717907;1864;1946;82
1897;180;56,367177;10,746981;1897;1940;43
1897;182;56,453059;10,866897;1868;1938;70
1897;188;55,513946;10,178703;1882;1938;56
1897;195;55,9775064;10,1756177;1890;2021;131
1897;209;56,633723;10,219662;1884;1914;30
1897;213;56,833601;10,113311;1885;1939;54
1897;215;56,886164;9,836899;1886;2009;123
1897;226;56,30839;9,469623;1897;1923;26
1897;236;56,090396;9,758625;1892;2021;129
1897;241;56,651494;8,934794;1855;1908;53
1897;242;56,673252;9,014768;1884;1921;37
1897;251;55,4226556;11,5675895;1889;1927;38
1897;257;55,074867;10,467835;1882;1953;71
1897;260;55,110103;10,734595;1867;1930;63
1897;268;56,327852;10,394815;1869;1919;50
1897;270;56,302138;10,477471;1894;2021;127
1897;294;55,471013;9,099652;1865;2021;156
1897;301;55,643464;9,651961;1889;2021;132
1897;303;55,84349;9,240195;1896;1905;9
1897;308;55,671645;9,5777;1867;1939;72
1897;315;56,552152;9,40118;1868;2021;153
1897;317;54,990073;11,986475;1897;1900;3
1897;322;54,9748134;12,2737822;1866;2021;155
1897;330;56,92528;10,018117;1866;1908;42
1897;336;56,032176;10,125522;1869;2005;136
1897;340;56,24119;10,199622;1895;1912;17
1897;341;56,262495;10,268877;1875;1920;45
1897;346;56,067076;10,134812;1866;2021;155
1897;13;55,18902;14,96054;1867;2021;154
1897;29;56,328077;10,04661;1876;2021;145
1897;47;55,82879;12,15363;1880;1917;37
1897;52;55,14476;10,34458;1889;1905;16
1897;191;55,1839;11,98427;1867;1947;80
1897;192;55,28643;11,55841;1852;1916;64
1897;202;55,39817;10,3966;1879;1920;41
1897;208;55,74166;11,41925;1865;2021;156
1897;212;56,51632;10,2095;1880;1917;37
1897;235;56,14912;9,91448;1868;1939;71
1897;252;55,2722;12,32416;1894;1953;59
1897;259;55,06429;10,59102;1889;1910;21
1897;267;56,36213;10,59199;1894;1897;3
1897;279;56,93435;8,53381;1895;1913;18
1897;290;55,62305;8,36912;1869;1918;49
1897;304;55,72746;9,53248;1879;1942;63
1897;332;56,94134;10,01256;1891;1899;8
1897;349;56,12853;10,16653;1857;1899;42
1898;6;55,269626;10,11524;1877;2009;132
1898;9;55,3772005;10,0466481;1886;1899;13
1898;15;57,2642721;9,9501182;1868;1904;36
1898;19;57,141564;10,224039;1873;1974;101
1898;24;55,4780403;8,4896729;1898;1903;5
1898;34;55,3214857;11,9687601;1891;1987;96
1898;36;55,306751;12,199669;1869;1924;55
1898;44;57,471613;10,410374;1875;1919;44
1898;55;55,242371;10,53961;1866;2021;155
1898;58;55,754371;12,544068;1884;1899;15
1898;65;54,6656231;11,7384629;1891;1902;11
1898;66;54,790388;11,944494;1878;1937;59
1898;67;54,7584557;11,7799705;1877;1905;28
1898;73;55,84433;9,589121;1848;2021;173
1898;75;55,731027;9,833955;1866;1939;73
1898;85;55,941434;12,268503;1895;1937;42
1898;90;57,562284;9,986481;1891;1967;76
1898;93;57,356497;9,936222;1890;2021;131
1898;96;55,610496;11,586514;1873;1917;44
1898;105;55,92122;9,997713;1894;1923;29
1898;110;55,965642;9,717756;1884;2006;122
1898;126;57,16496;9,729678;1877;1951;74
1898;128;55,512352;11,287189;1866;1930;64
1898;142;55,7217;12,543237;1872;1913;41
1898;144;55,673798;12,577517;1891;2021;130
1898;145;55,682456;12,569828;1877;2021;144
1898;151;54,861238;10,73061;1867;1978;111
1898;155;56,557877;8,412895;1887;1976;89
1898;160;55,78677;12,495101;1890;1937;47
1898;175;55,43019;9,871348;1892;1901;9
1898;176;55,460727;9,822756;1880;1960;80
1898;177;56,839448;8,717907;1864;1946;82
1898;180;56,367177;10,746981;1897;1940;43
1898;182;56,453059;10,866897;1868;1938;70
1898;188;55,513946;10,178703;1882;1938;56
1898;195;55,9775064;10,1756177;1890;2021;131
1898;209;56,633723;10,219662;1884;1914;30
1898;213;56,833601;10,113311;1885;1939;54
1898;215;56,886164;9,836899;1886;2009;123
1898;226;56,30839;9,469623;1897;1923;26
1898;236;56,090396;9,758625;1892;2021;129
1898;241;56,651494;8,934794;1855;1908;53
1898;242;56,673252;9,014768;1884;1921;37
1898;251;55,4226556;11,5675895;1889;1927;38
1898;257;55,074867;10,467835;1882;1953;71
1898;260;55,110103;10,734595;1867;1930;63
1898;268;56,327852;10,394815;1869;1919;50
1898;270;56,302138;10,477471;1894;2021;127
1898;294;55,471013;9,099652;1865;2021;156
1898;301;55,643464;9,651961;1889;2021;132
1898;303;55,84349;9,240195;1896;1905;9
1898;308;55,671645;9,5777;1867;1939;72
1898;315;56,552152;9,40118;1868;2021;153
1898;317;54,990073;11,986475;1897;1900;3
1898;322;54,9748134;12,2737822;1866;2021;155
1898;330;56,92528;10,018117;1866;1908;42
1898;336;56,032176;10,125522;1869;2005;136
1898;340;56,24119;10,199622;1895;1912;17
1898;341;56,262495;10,268877;1875;1920;45
1898;346;56,067076;10,134812;1866;2021;155
1898;13;55,18902;14,96054;1867;2021;154
1898;29;56,328077;10,04661;1876;2021;145
1898;45;57,32226;10,38428;1898;1912;14
1898;47;55,82879;12,15363;1880;1917;37
1898;52;55,14476;10,34458;1889;1905;16
1898;191;55,1839;11,98427;1867;1947;80
1898;192;55,28643;11,55841;1852;1916;64
1898;202;55,39817;10,3966;1879;1920;41
1898;208;55,74166;11,41925;1865;2021;156
1898;212;56,51632;10,2095;1880;1917;37
1898;235;56,14912;9,91448;1868;1939;71
1898;252;55,2722;12,32416;1894;1953;59
1898;259;55,06429;10,59102;1889;1910;21
1898;279;56,93435;8,53381;1895;1913;18
1898;290;55,62305;8,36912;1869;1918;49
1898;304;55,72746;9,53248;1879;1942;63
1898;332;56,94134;10,01256;1891;1899;8
1898;349;56,12853;10,16653;1857;1899;42
1899;6;55,269626;10,11524;1877;2009;132
1899;9;55,3772005;10,0466481;1886;1899;13
1899;15;57,2642721;9,9501182;1868;1904;36
1899;19;57,141564;10,224039;1873;1974;101
1899;24;55,4780403;8,4896729;1898;1903;5
1899;34;55,3214857;11,9687601;1891;1987;96
1899;36;55,306751;12,199669;1869;1924;55
1899;44;57,471613;10,410374;1875;1919;44
1899;55;55,242371;10,53961;1866;2021;155
1899;58;55,754371;12,544068;1884;1899;15
1899;65;54,6656231;11,7384629;1891;1902;11
1899;66;54,790388;11,944494;1878;1937;59
1899;67;54,7584557;11,7799705;1877;1905;28
1899;73;55,84433;9,589121;1848;2021;173
1899;75;55,731027;9,833955;1866;1939;73
1899;85;55,941434;12,268503;1895;1937;42
1899;90;57,562284;9,986481;1891;1967;76
1899;93;57,356497;9,936222;1890;2021;131
1899;96;55,610496;11,586514;1873;1917;44
1899;105;55,92122;9,997713;1894;1923;29
1899;110;55,965642;9,717756;1884;2006;122
1899;126;57,16496;9,729678;1877;1951;74
1899;128;55,512352;11,287189;1866;1930;64
1899;140;55,585667;9,423096;1899;1961;62
1899;142;55,7217;12,543237;1872;1913;41
1899;144;55,673798;12,577517;1891;2021;130
1899;145;55,682456;12,569828;1877;2021;144
1899;151;54,861238;10,73061;1867;1978;111
1899;155;56,557877;8,412895;1887;1976;89
1899;160;55,78677;12,495101;1890;1937;47
1899;175;55,43019;9,871348;1892;1901;9
1899;176;55,460727;9,822756;1880;1960;80
1899;177;56,839448;8,717907;1864;1946;82
1899;180;56,367177;10,746981;1897;1940;43
1899;182;56,453059;10,866897;1868;1938;70
1899;188;55,513946;10,178703;1882;1938;56
1899;195;55,9775064;10,1756177;1890;2021;131
1899;209;56,633723;10,219662;1884;1914;30
1899;213;56,833601;10,113311;1885;1939;54
1899;215;56,886164;9,836899;1886;2009;123
1899;226;56,30839;9,469623;1897;1923;26
1899;236;56,090396;9,758625;1892;2021;129
1899;241;56,651494;8,934794;1855;1908;53
1899;242;56,673252;9,014768;1884;1921;37
1899;251;55,4226556;11,5675895;1889;1927;38
1899;257;55,074867;10,467835;1882;1953;71
1899;260;55,110103;10,734595;1867;1930;63
1899;268;56,327852;10,394815;1869;1919;50
1899;270;56,302138;10,477471;1894;2021;127
1899;294;55,471013;9,099652;1865;2021;156
1899;301;55,643464;9,651961;1889;2021;132
1899;303;55,84349;9,240195;1896;1905;9
1899;308;55,671645;9,5777;1867;1939;72
1899;315;56,552152;9,40118;1868;2021;153
1899;317;54,990073;11,986475;1897;1900;3
1899;322;54,9748134;12,2737822;1866;2021;155
1899;330;56,92528;10,018117;1866;1908;42
1899;336;56,032176;10,125522;1869;2005;136
1899;340;56,24119;10,199622;1895;1912;17
1899;341;56,262495;10,268877;1875;1920;45
1899;346;56,067076;10,134812;1866;2021;155
1899;13;55,18902;14,96054;1867;2021;154
1899;29;56,328077;10,04661;1876;2021;145
1899;45;57,32226;10,38428;1898;1912;14
1899;47;55,82879;12,15363;1880;1917;37
1899;52;55,14476;10,34458;1889;1905;16
1899;130;55,67057;11,18151;1899;2021;122
1899;191;55,1839;11,98427;1867;1947;80
1899;192;55,28643;11,55841;1852;1916;64
1899;202;55,39817;10,3966;1879;1920;41
1899;208;55,74166;11,41925;1865;2021;156
1899;212;56,51632;10,2095;1880;1917;37
1899;235;56,14912;9,91448;1868;1939;71
1899;252;55,2722;12,32416;1894;1953;59
1899;259;55,06429;10,59102;1889;1910;21
1899;279;56,93435;8,53381;1895;1913;18
1899;290;55,62305;8,36912;1869;1918;49
1899;304;55,72746;9,53248;1879;1942;63
1899;331;56,99987;9,99301;1899;1928;29
1899;332;56,94134;10,01256;1891;1899;8
1899;349;56,12853;10,16653;1857;1899;42
1900;6;55,269626;10,11524;1877;2009;132
1900;15;57,2642721;9,9501182;1868;1904;36
1900;19;57,141564;10,224039;1873;1974;101
1900;24;55,4780403;8,4896729;1898;1903;5
1900;34;55,3214857;11,9687601;1891;1987;96
1900;36;55,306751;12,199669;1869;1924;55
1900;44;57,471613;10,410374;1875;1919;44
1900;55;55,242371;10,53961;1866;2021;155
1900;65;54,6656231;11,7384629;1891;1902;11
1900;66;54,790388;11,944494;1878;1937;59
1900;67;54,7584557;11,7799705;1877;1905;28
1900;73;55,84433;9,589121;1848;2021;173
1900;75;55,731027;9,833955;1866;1939;73
1900;85;55,941434;12,268503;1895;1937;42
1900;90;57,562284;9,986481;1891;1967;76
1900;93;57,356497;9,936222;1890;2021;131
1900;96;55,610496;11,586514;1873;1917;44
1900;105;55,92122;9,997713;1894;1923;29
1900;110;55,965642;9,717756;1884;2006;122
1900;126;57,16496;9,729678;1877;1951;74
1900;128;55,512352;11,287189;1866;1930;64
1900;140;55,585667;9,423096;1899;1961;62
1900;142;55,7217;12,543237;1872;1913;41
1900;144;55,673798;12,577517;1891;2021;130
1900;145;55,682456;12,569828;1877;2021;144
1900;151;54,861238;10,73061;1867;1978;111
1900;155;56,557877;8,412895;1887;1976;89
1900;160;55,78677;12,495101;1890;1937;47
1900;175;55,43019;9,871348;1892;1901;9
1900;176;55,460727;9,822756;1880;1960;80
1900;177;56,839448;8,717907;1864;1946;82
1900;180;56,367177;10,746981;1897;1940;43
1900;182;56,453059;10,866897;1868;1938;70
1900;188;55,513946;10,178703;1882;1938;56
1900;195;55,9775064;10,1756177;1890;2021;131
1900;209;56,633723;10,219662;1884;1914;30
1900;213;56,833601;10,113311;1885;1939;54
1900;215;56,886164;9,836899;1886;2009;123
1900;226;56,30839;9,469623;1897;1923;26
1900;236;56,090396;9,758625;1892;2021;129
1900;241;56,651494;8,934794;1855;1908;53
1900;242;56,673252;9,014768;1884;1921;37
1900;251;55,4226556;11,5675895;1889;1927;38
1900;257;55,074867;10,467835;1882;1953;71
1900;260;55,110103;10,734595;1867;1930;63
1900;268;56,327852;10,394815;1869;1919;50
1900;270;56,302138;10,477471;1894;2021;127
1900;294;55,471013;9,099652;1865;2021;156
1900;301;55,643464;9,651961;1889;2021;132
1900;303;55,84349;9,240195;1896;1905;9
1900;308;55,671645;9,5777;1867;1939;72
1900;315;56,552152;9,40118;1868;2021;153
1900;317;54,990073;11,986475;1897;1900;3
1900;322;54,9748134;12,2737822;1866;2021;155
1900;330;56,92528;10,018117;1866;1908;42
1900;336;56,032176;10,125522;1869;2005;136
1900;340;56,24119;10,199622;1895;1912;17
1900;341;56,262495;10,268877;1875;1920;45
1900;346;56,067076;10,134812;1866;2021;155
1900;13;55,18902;14,96054;1867;2021;154
1900;29;56,328077;10,04661;1876;2021;145
1900;45;57,32226;10,38428;1898;1912;14
1900;47;55,82879;12,15363;1880;1917;37
1900;52;55,14476;10,34458;1889;1905;16
1900;130;55,67057;11,18151;1899;2021;122
1900;191;55,1839;11,98427;1867;1947;80
1900;192;55,28643;11,55841;1852;1916;64
1900;202;55,39817;10,3966;1879;1920;41
1900;208;55,74166;11,41925;1865;2021;156
1900;212;56,51632;10,2095;1880;1917;37
1900;235;56,14912;9,91448;1868;1939;71
1900;252;55,2722;12,32416;1894;1953;59
1900;253;55,40862;12,1951;1900;1929;29
1900;259;55,06429;10,59102;1889;1910;21
1900;279;56,93435;8,53381;1895;1913;18
1900;290;55,62305;8,36912;1869;1918;49
1900;304;55,72746;9,53248;1879;1942;63
1900;331;56,99987;9,99301;1899;1928;29
1901;6;55,269626;10,11524;1877;2009;132
1901;15;57,2642721;9,9501182;1868;1904;36
1901;19;57,141564;10,224039;1873;1974;101
1901;24;55,4780403;8,4896729;1898;1903;5
1901;34;55,3214857;11,9687601;1891;1987;96
1901;36;55,306751;12,199669;1869;1924;55
1901;44;57,471613;10,410374;1875;1919;44
1901;55;55,242371;10,53961;1866;2021;155
1901;65;54,6656231;11,7384629;1891;1902;11
1901;66;54,790388;11,944494;1878;1937;59
1901;67;54,7584557;11,7799705;1877;1905;28
1901;73;55,84433;9,589121;1848;2021;173
1901;75;55,731027;9,833955;1866;1939;73
1901;85;55,941434;12,268503;1895;1937;42
1901;90;57,562284;9,986481;1891;1967;76
1901;93;57,356497;9,936222;1890;2021;131
1901;96;55,610496;11,586514;1873;1917;44
1901;105;55,92122;9,997713;1894;1923;29
1901;110;55,965642;9,717756;1884;2006;122
1901;126;57,16496;9,729678;1877;1951;74
1901;128;55,512352;11,287189;1866;1930;64
1901;140;55,585667;9,423096;1899;1961;62
1901;142;55,7217;12,543237;1872;1913;41
1901;144;55,673798;12,577517;1891;2021;130
1901;145;55,682456;12,569828;1877;2021;144
1901;151;54,861238;10,73061;1867;1978;111
1901;155;56,557877;8,412895;1887;1976;89
1901;160;55,78677;12,495101;1890;1937;47
1901;175;55,43019;9,871348;1892;1901;9
1901;176;55,460727;9,822756;1880;1960;80
1901;177;56,839448;8,717907;1864;1946;82
1901;180;56,367177;10,746981;1897;1940;43
1901;182;56,453059;10,866897;1868;1938;70
1901;188;55,513946;10,178703;1882;1938;56
1901;195;55,9775064;10,1756177;1890;2021;131
1901;209;56,633723;10,219662;1884;1914;30
1901;213;56,833601;10,113311;1885;1939;54
1901;215;56,886164;9,836899;1886;2009;123
1901;226;56,30839;9,469623;1897;1923;26
1901;236;56,090396;9,758625;1892;2021;129
1901;241;56,651494;8,934794;1855;1908;53
1901;242;56,673252;9,014768;1884;1921;37
1901;251;55,4226556;11,5675895;1889;1927;38
1901;257;55,074867;10,467835;1882;1953;71
1901;260;55,110103;10,734595;1867;1930;63
1901;268;56,327852;10,394815;1869;1919;50
1901;270;56,302138;10,477471;1894;2021;127
1901;294;55,471013;9,099652;1865;2021;156
1901;301;55,643464;9,651961;1889;2021;132
1901;303;55,84349;9,240195;1896;1905;9
1901;308;55,671645;9,5777;1867;1939;72
1901;315;56,552152;9,40118;1868;2021;153
1901;322;54,9748134;12,2737822;1866;2021;155
1901;330;56,92528;10,018117;1866;1908;42
1901;336;56,032176;10,125522;1869;2005;136
1901;340;56,24119;10,199622;1895;1912;17
1901;341;56,262495;10,268877;1875;1920;45
1901;346;56,067076;10,134812;1866;2021;155
1901;13;55,18902;14,96054;1867;2021;154
1901;29;56,328077;10,04661;1876;2021;145
1901;45;57,32226;10,38428;1898;1912;14
1901;47;55,82879;12,15363;1880;1917;37
1901;52;55,14476;10,34458;1889;1905;16
1901;130;55,67057;11,18151;1899;2021;122
1901;191;55,1839;11,98427;1867;1947;80
1901;192;55,28643;11,55841;1852;1916;64
1901;202;55,39817;10,3966;1879;1920;41
1901;208;55,74166;11,41925;1865;2021;156
1901;212;56,51632;10,2095;1880;1917;37
1901;235;56,14912;9,91448;1868;1939;71
1901;252;55,2722;12,32416;1894;1953;59
1901;253;55,40862;12,1951;1900;1929;29
1901;259;55,06429;10,59102;1889;1910;21
1901;279;56,93435;8,53381;1895;1913;18
1901;290;55,62305;8,36912;1869;1918;49
1901;304;55,72746;9,53248;1879;1942;63
1901;331;56,99987;9,99301;1899;1928;29
1902;6;55,269626;10,11524;1877;2009;132
1902;15;57,2642721;9,9501182;1868;1904;36
1902;19;57,141564;10,224039;1873;1974;101
1902;24;55,4780403;8,4896729;1898;1903;5
1902;34;55,3214857;11,9687601;1891;1987;96
1902;36;55,306751;12,199669;1869;1924;55
1902;44;57,471613;10,410374;1875;1919;44
1902;55;55,242371;10,53961;1866;2021;155
1902;65;54,6656231;11,7384629;1891;1902;11
1902;66;54,790388;11,944494;1878;1937;59
1902;67;54,7584557;11,7799705;1877;1905;28
1902;73;55,84433;9,589121;1848;2021;173
1902;75;55,731027;9,833955;1866;1939;73
1902;85;55,941434;12,268503;1895;1937;42
1902;90;57,562284;9,986481;1891;1967;76
1902;93;57,356497;9,936222;1890;2021;131
1902;96;55,610496;11,586514;1873;1917;44
1902;105;55,92122;9,997713;1894;1923;29
1902;110;55,965642;9,717756;1884;2006;122
1902;126;57,16496;9,729678;1877;1951;74
1902;128;55,512352;11,287189;1866;1930;64
1902;140;55,585667;9,423096;1899;1961;62
1902;142;55,7217;12,543237;1872;1913;41
1902;144;55,673798;12,577517;1891;2021;130
1902;145;55,682456;12,569828;1877;2021;144
1902;151;54,861238;10,73061;1867;1978;111
1902;155;56,557877;8,412895;1887;1976;89
1902;160;55,78677;12,495101;1890;1937;47
1902;176;55,460727;9,822756;1880;1960;80
1902;177;56,839448;8,717907;1864;1946;82
1902;180;56,367177;10,746981;1897;1940;43
1902;182;56,453059;10,866897;1868;1938;70
1902;188;55,513946;10,178703;1882;1938;56
1902;195;55,9775064;10,1756177;1890;2021;131
1902;209;56,633723;10,219662;1884;1914;30
1902;213;56,833601;10,113311;1885;1939;54
1902;215;56,886164;9,836899;1886;2009;123
1902;226;56,30839;9,469623;1897;1923;26
1902;236;56,090396;9,758625;1892;2021;129
1902;241;56,651494;8,934794;1855;1908;53
1902;242;56,673252;9,014768;1884;1921;37
1902;251;55,4226556;11,5675895;1889;1927;38
1902;257;55,074867;10,467835;1882;1953;71
1902;260;55,110103;10,734595;1867;1930;63
1902;268;56,327852;10,394815;1869;1919;50
1902;270;56,302138;10,477471;1894;2021;127
1902;294;55,471013;9,099652;1865;2021;156
1902;301;55,643464;9,651961;1889;2021;132
1902;303;55,84349;9,240195;1896;1905;9
1902;308;55,671645;9,5777;1867;1939;72
1902;315;56,552152;9,40118;1868;2021;153
1902;322;54,9748134;12,2737822;1866;2021;155
1902;330;56,92528;10,018117;1866;1908;42
1902;336;56,032176;10,125522;1869;2005;136
1902;340;56,24119;10,199622;1895;1912;17
1902;341;56,262495;10,268877;1875;1920;45
1902;346;56,067076;10,134812;1866;2021;155
1902;13;55,18902;14,96054;1867;2021;154
1902;29;56,328077;10,04661;1876;2021;145
1902;45;57,32226;10,38428;1898;1912;14
1902;47;55,82879;12,15363;1880;1917;37
1902;52;55,14476;10,34458;1889;1905;16
1902;130;55,67057;11,18151;1899;2021;122
1902;191;55,1839;11,98427;1867;1947;80
1902;192;55,28643;11,55841;1852;1916;64
1902;202;55,39817;10,3966;1879;1920;41
1902;208;55,74166;11,41925;1865;2021;156
1902;212;56,51632;10,2095;1880;1917;37
1902;235;56,14912;9,91448;1868;1939;71
1902;252;55,2722;12,32416;1894;1953;59
1902;253;55,40862;12,1951;1900;1929;29
1902;259;55,06429;10,59102;1889;1910;21
1902;279;56,93435;8,53381;1895;1913;18
1902;290;55,62305;8,36912;1869;1918;49
1902;304;55,72746;9,53248;1879;1942;63
1902;331;56,99987;9,99301;1899;1928;29
1903;6;55,269626;10,11524;1877;2009;132
1903;15;57,2642721;9,9501182;1868;1904;36
1903;19;57,141564;10,224039;1873;1974;101
1903;24;55,4780403;8,4896729;1898;1903;5
1903;34;55,3214857;11,9687601;1891;1987;96
1903;36;55,306751;12,199669;1869;1924;55
1903;44;57,471613;10,410374;1875;1919;44
1903;55;55,242371;10,53961;1866;2021;155
1903;66;54,790388;11,944494;1878;1937;59
1903;67;54,7584557;11,7799705;1877;1905;28
1903;73;55,84433;9,589121;1848;2021;173
1903;75;55,731027;9,833955;1866;1939;73
1903;85;55,941434;12,268503;1895;1937;42
1903;90;57,562284;9,986481;1891;1967;76
1903;93;57,356497;9,936222;1890;2021;131
1903;96;55,610496;11,586514;1873;1917;44
1903;105;55,92122;9,997713;1894;1923;29
1903;110;55,965642;9,717756;1884;2006;122
1903;126;57,16496;9,729678;1877;1951;74
1903;128;55,512352;11,287189;1866;1930;64
1903;140;55,585667;9,423096;1899;1961;62
1903;142;55,7217;12,543237;1872;1913;41
1903;144;55,673798;12,577517;1891;2021;130
1903;145;55,682456;12,569828;1877;2021;144
1903;151;54,861238;10,73061;1867;1978;111
1903;155;56,557877;8,412895;1887;1976;89
1903;160;55,78677;12,495101;1890;1937;47
1903;176;55,460727;9,822756;1880;1960;80
1903;177;56,839448;8,717907;1864;1946;82
1903;180;56,367177;10,746981;1897;1940;43
1903;181;56,483472;10,446191;1903;1932;29
1903;182;56,453059;10,866897;1868;1938;70
1903;188;55,513946;10,178703;1882;1938;56
1903;195;55,9775064;10,1756177;1890;2021;131
1903;209;56,633723;10,219662;1884;1914;30
1903;213;56,833601;10,113311;1885;1939;54
1903;215;56,886164;9,836899;1886;2009;123
1903;226;56,30839;9,469623;1897;1923;26
1903;236;56,090396;9,758625;1892;2021;129
1903;241;56,651494;8,934794;1855;1908;53
1903;242;56,673252;9,014768;1884;1921;37
1903;251;55,4226556;11,5675895;1889;1927;38
1903;257;55,074867;10,467835;1882;1953;71
1903;260;55,110103;10,734595;1867;1930;63
1903;268;56,327852;10,394815;1869;1919;50
1903;270;56,302138;10,477471;1894;2021;127
1903;294;55,471013;9,099652;1865;2021;156
1903;301;55,643464;9,651961;1889;2021;132
1903;303;55,84349;9,240195;1896;1905;9
1903;308;55,671645;9,5777;1867;1939;72
1903;315;56,552152;9,40118;1868;2021;153
1903;322;54,9748134;12,2737822;1866;2021;155
1903;330;56,92528;10,018117;1866;1908;42
1903;336;56,032176;10,125522;1869;2005;136
1903;340;56,24119;10,199622;1895;1912;17
1903;341;56,262495;10,268877;1875;1920;45
1903;346;56,067076;10,134812;1866;2021;155
1903;13;55,18902;14,96054;1867;2021;154
1903;29;56,328077;10,04661;1876;2021;145
1903;45;57,32226;10,38428;1898;1912;14
1903;47;55,82879;12,15363;1880;1917;37
1903;52;55,14476;10,34458;1889;1905;16
1903;130;55,67057;11,18151;1899;2021;122
1903;137;55,40711;9,55068;1903;1918;15
1903;191;55,1839;11,98427;1867;1947;80
1903;192;55,28643;11,55841;1852;1916;64
1903;202;55,39817;10,3966;1879;1920;41
1903;208;55,74166;11,41925;1865;2021;156
1903;212;56,51632;10,2095;1880;1917;37
1903;235;56,14912;9,91448;1868;1939;71
1903;252;55,2722;12,32416;1894;1953;59
1903;253;55,40862;12,1951;1900;1929;29
1903;259;55,06429;10,59102;1889;1910;21
1903;279;56,93435;8,53381;1895;1913;18
1903;290;55,62305;8,36912;1869;1918;49
1903;304;55,72746;9,53248;1879;1942;63
1903;331;56,99987;9,99301;1899;1928;29
1904;6;55,269626;10,11524;1877;2009;132
1904;15;57,2642721;9,9501182;1868;1904;36
1904;19;57,141564;10,224039;1873;1974;101
1904;34;55,3214857;11,9687601;1891;1987;96
1904;36;55,306751;12,199669;1869;1924;55
1904;44;57,471613;10,410374;1875;1919;44
1904;55;55,242371;10,53961;1866;2021;155
1904;66;54,790388;11,944494;1878;1937;59
1904;67;54,7584557;11,7799705;1877;1905;28
1904;73;55,84433;9,589121;1848;2021;173
1904;75;55,731027;9,833955;1866;1939;73
1904;85;55,941434;12,268503;1895;1937;42
1904;90;57,562284;9,986481;1891;1967;76
1904;93;57,356497;9,936222;1890;2021;131
1904;96;55,610496;11,586514;1873;1917;44
1904;105;55,92122;9,997713;1894;1923;29
1904;110;55,965642;9,717756;1884;2006;122
1904;126;57,16496;9,729678;1877;1951;74
1904;128;55,512352;11,287189;1866;1930;64
1904;140;55,585667;9,423096;1899;1961;62
1904;142;55,7217;12,543237;1872;1913;41
1904;144;55,673798;12,577517;1891;2021;130
1904;145;55,682456;12,569828;1877;2021;144
1904;151;54,861238;10,73061;1867;1978;111
1904;155;56,557877;8,412895;1887;1976;89
1904;160;55,78677;12,495101;1890;1937;47
1904;176;55,460727;9,822756;1880;1960;80
1904;177;56,839448;8,717907;1864;1946;82
1904;180;56,367177;10,746981;1897;1940;43
1904;181;56,483472;10,446191;1903;1932;29
1904;182;56,453059;10,866897;1868;1938;70
1904;188;55,513946;10,178703;1882;1938;56
1904;195;55,9775064;10,1756177;1890;2021;131
1904;209;56,633723;10,219662;1884;1914;30
1904;213;56,833601;10,113311;1885;1939;54
1904;215;56,886164;9,836899;1886;2009;123
1904;226;56,30839;9,469623;1897;1923;26
1904;236;56,090396;9,758625;1892;2021;129
1904;241;56,651494;8,934794;1855;1908;53
1904;242;56,673252;9,014768;1884;1921;37
1904;251;55,4226556;11,5675895;1889;1927;38
1904;257;55,074867;10,467835;1882;1953;71
1904;260;55,110103;10,734595;1867;1930;63
1904;268;56,327852;10,394815;1869;1919;50
1904;270;56,302138;10,477471;1894;2021;127
1904;294;55,471013;9,099652;1865;2021;156
1904;301;55,643464;9,651961;1889;2021;132
1904;303;55,84349;9,240195;1896;1905;9
1904;308;55,671645;9,5777;1867;1939;72
1904;315;56,552152;9,40118;1868;2021;153
1904;322;54,9748134;12,2737822;1866;2021;155
1904;330;56,92528;10,018117;1866;1908;42
1904;336;56,032176;10,125522;1869;2005;136
1904;340;56,24119;10,199622;1895;1912;17
1904;341;56,262495;10,268877;1875;1920;45
1904;346;56,067076;10,134812;1866;2021;155
1904;13;55,18902;14,96054;1867;2021;154
1904;29;56,328077;10,04661;1876;2021;145
1904;45;57,32226;10,38428;1898;1912;14
1904;47;55,82879;12,15363;1880;1917;37
1904;52;55,14476;10,34458;1889;1905;16
1904;130;55,67057;11,18151;1899;2021;122
1904;137;55,40711;9,55068;1903;1918;15
1904;191;55,1839;11,98427;1867;1947;80
1904;192;55,28643;11,55841;1852;1916;64
1904;202;55,39817;10,3966;1879;1920;41
1904;208;55,74166;11,41925;1865;2021;156
1904;212;56,51632;10,2095;1880;1917;37
1904;235;56,14912;9,91448;1868;1939;71
1904;252;55,2722;12,32416;1894;1953;59
1904;253;55,40862;12,1951;1900;1929;29
1904;259;55,06429;10,59102;1889;1910;21
1904;279;56,93435;8,53381;1895;1913;18
1904;290;55,62305;8,36912;1869;1918;49
1904;304;55,72746;9,53248;1879;1942;63
1904;331;56,99987;9,99301;1899;1928;29
1905;6;55,269626;10,11524;1877;2009;132
1905;19;57,141564;10,224039;1873;1974;101
1905;34;55,3214857;11,9687601;1891;1987;96
1905;36;55,306751;12,199669;1869;1924;55
1905;44;57,471613;10,410374;1875;1919;44
1905;55;55,242371;10,53961;1866;2021;155
1905;63;54,8625896;11,7333453;1905;1918;13
1905;66;54,790388;11,944494;1878;1937;59
1905;67;54,7584557;11,7799705;1877;1905;28
1905;73;55,84433;9,589121;1848;2021;173
1905;75;55,731027;9,833955;1866;1939;73
1905;85;55,941434;12,268503;1895;1937;42
1905;90;57,562284;9,986481;1891;1967;76
1905;93;57,356497;9,936222;1890;2021;131
1905;96;55,610496;11,586514;1873;1917;44
1905;105;55,92122;9,997713;1894;1923;29
1905;110;55,965642;9,717756;1884;2006;122
1905;126;57,16496;9,729678;1877;1951;74
1905;128;55,512352;11,287189;1866;1930;64
1905;140;55,585667;9,423096;1899;1961;62
1905;142;55,7217;12,543237;1872;1913;41
1905;144;55,673798;12,577517;1891;2021;130
1905;145;55,682456;12,569828;1877;2021;144
1905;151;54,861238;10,73061;1867;1978;111
1905;155;56,557877;8,412895;1887;1976;89
1905;158;54,815811;11,264489;1905;1996;91
1905;160;55,78677;12,495101;1890;1937;47
1905;176;55,460727;9,822756;1880;1960;80
1905;177;56,839448;8,717907;1864;1946;82
1905;180;56,367177;10,746981;1897;1940;43
1905;181;56,483472;10,446191;1903;1932;29
1905;182;56,453059;10,866897;1868;1938;70
1905;188;55,513946;10,178703;1882;1938;56
1905;195;55,9775064;10,1756177;1890;2021;131
1905;209;56,633723;10,219662;1884;1914;30
1905;213;56,833601;10,113311;1885;1939;54
1905;215;56,886164;9,836899;1886;2009;123
1905;226;56,30839;9,469623;1897;1923;26
1905;236;56,090396;9,758625;1892;2021;129
1905;241;56,651494;8,934794;1855;1908;53
1905;242;56,673252;9,014768;1884;1921;37
1905;251;55,4226556;11,5675895;1889;1927;38
1905;257;55,074867;10,467835;1882;1953;71
1905;260;55,110103;10,734595;1867;1930;63
1905;268;56,327852;10,394815;1869;1919;50
1905;270;56,302138;10,477471;1894;2021;127
1905;294;55,471013;9,099652;1865;2021;156
1905;301;55,643464;9,651961;1889;2021;132
1905;303;55,84349;9,240195;1896;1905;9
1905;308;55,671645;9,5777;1867;1939;72
1905;315;56,552152;9,40118;1868;2021;153
1905;322;54,9748134;12,2737822;1866;2021;155
1905;326;54,934174;9,248837;1905;1951;46
1905;330;56,92528;10,018117;1866;1908;42
1905;336;56,032176;10,125522;1869;2005;136
1905;340;56,24119;10,199622;1895;1912;17
1905;341;56,262495;10,268877;1875;1920;45
1905;346;56,067076;10,134812;1866;2021;155
1905;13;55,18902;14,96054;1867;2021;154
1905;29;56,328077;10,04661;1876;2021;145
1905;45;57,32226;10,38428;1898;1912;14
1905;47;55,82879;12,15363;1880;1917;37
1905;52;55,14476;10,34458;1889;1905;16
1905;115;55,88581;12,51109;1905;1958;53
1905;130;55,67057;11,18151;1899;2021;122
1905;137;55,40711;9,55068;1903;1918;15
1905;191;55,1839;11,98427;1867;1947;80
1905;192;55,28643;11,55841;1852;1916;64
1905;202;55,39817;10,3966;1879;1920;41
1905;208;55,74166;11,41925;1865;2021;156
1905;212;56,51632;10,2095;1880;1917;37
1905;235;56,14912;9,91448;1868;1939;71
1905;252;55,2722;12,32416;1894;1953;59
1905;253;55,40862;12,1951;1900;1929;29
1905;259;55,06429;10,59102;1889;1910;21
1905;279;56,93435;8,53381;1895;1913;18
1905;290;55,62305;8,36912;1869;1918;49
1905;304;55,72746;9,53248;1879;1942;63
1905;331;56,99987;9,99301;1899;1928;29
1906;6;55,269626;10,11524;1877;2009;132
1906;7;55,325496;10,197316;1906;1976;70
1906;19;57,141564;10,224039;1873;1974;101
1906;34;55,3214857;11,9687601;1891;1987;96
1906;36;55,306751;12,199669;1869;1924;55
1906;44;57,471613;10,410374;1875;1919;44
1906;55;55,242371;10,53961;1866;2021;155
1906;63;54,8625896;11,7333453;1905;1918;13
1906;66;54,790388;11,944494;1878;1937;59
1906;73;55,84433;9,589121;1848;2021;173
1906;75;55,731027;9,833955;1866;1939;73
1906;85;55,941434;12,268503;1895;1937;42
1906;90;57,562284;9,986481;1891;1967;76
1906;93;57,356497;9,936222;1890;2021;131
1906;96;55,610496;11,586514;1873;1917;44
1906;105;55,92122;9,997713;1894;1923;29
1906;110;55,965642;9,717756;1884;2006;122
1906;126;57,16496;9,729678;1877;1951;74
1906;128;55,512352;11,287189;1866;1930;64
1906;140;55,585667;9,423096;1899;1961;62
1906;142;55,7217;12,543237;1872;1913;41
1906;144;55,673798;12,577517;1891;2021;130
1906;145;55,682456;12,569828;1877;2021;144
1906;151;54,861238;10,73061;1867;1978;111
1906;155;56,557877;8,412895;1887;1976;89
1906;158;54,815811;11,264489;1905;1996;91
1906;160;55,78677;12,495101;1890;1937;47
1906;176;55,460727;9,822756;1880;1960;80
1906;177;56,839448;8,717907;1864;1946;82
1906;180;56,367177;10,746981;1897;1940;43
1906;181;56,483472;10,446191;1903;1932;29
1906;182;56,453059;10,866897;1868;1938;70
1906;188;55,513946;10,178703;1882;1938;56
1906;195;55,9775064;10,1756177;1890;2021;131
1906;209;56,633723;10,219662;1884;1914;30
1906;213;56,833601;10,113311;1885;1939;54
1906;215;56,886164;9,836899;1886;2009;123
1906;226;56,30839;9,469623;1897;1923;26
1906;236;56,090396;9,758625;1892;2021;129
1906;241;56,651494;8,934794;1855;1908;53
1906;242;56,673252;9,014768;1884;1921;37
1906;251;55,4226556;11,5675895;1889;1927;38
1906;257;55,074867;10,467835;1882;1953;71
1906;260;55,110103;10,734595;1867;1930;63
1906;268;56,327852;10,394815;1869;1919;50
1906;270;56,302138;10,477471;1894;2021;127
1906;294;55,471013;9,099652;1865;2021;156
1906;301;55,643464;9,651961;1889;2021;132
1906;308;55,671645;9,5777;1867;1939;72
1906;315;56,552152;9,40118;1868;2021;153
1906;322;54,9748134;12,2737822;1866;2021;155
1906;326;54,934174;9,248837;1905;1951;46
1906;330;56,92528;10,018117;1866;1908;42
1906;336;56,032176;10,125522;1869;2005;136
1906;340;56,24119;10,199622;1895;1912;17
1906;341;56,262495;10,268877;1875;1920;45
1906;346;56,067076;10,134812;1866;2021;155
1906;348;56,1913548;10,2204192;1906;1921;15
1906;13;55,18902;14,96054;1867;2021;154
1906;29;56,328077;10,04661;1876;2021;145
1906;45;57,32226;10,38428;1898;1912;14
1906;47;55,82879;12,15363;1880;1917;37
1906;115;55,88581;12,51109;1905;1958;53
1906;130;55,67057;11,18151;1899;2021;122
1906;137;55,40711;9,55068;1903;1918;15
1906;191;55,1839;11,98427;1867;1947;80
1906;192;55,28643;11,55841;1852;1916;64
1906;202;55,39817;10,3966;1879;1920;41
1906;208;55,74166;11,41925;1865;2021;156
1906;212;56,51632;10,2095;1880;1917;37
1906;227;56,09678;9,58179;1906;1911;5
1906;235;56,14912;9,91448;1868;1939;71
1906;252;55,2722;12,32416;1894;1953;59
1906;253;55,40862;12,1951;1900;1929;29
1906;259;55,06429;10,59102;1889;1910;21
1906;279;56,93435;8,53381;1895;1913;18
1906;290;55,62305;8,36912;1869;1918;49
1906;304;55,72746;9,53248;1879;1942;63
1906;331;56,99987;9,99301;1899;1928;29
1907;6;55,269626;10,11524;1877;2009;132
1907;7;55,325496;10,197316;1906;1976;70
1907;19;57,141564;10,224039;1873;1974;101
1907;34;55,3214857;11,9687601;1891;1987;96
1907;36;55,306751;12,199669;1869;1924;55
1907;44;57,471613;10,410374;1875;1919;44
1907;55;55,242371;10,53961;1866;2021;155
1907;63;54,8625896;11,7333453;1905;1918;13
1907;66;54,790388;11,944494;1878;1937;59
1907;73;55,84433;9,589121;1848;2021;173
1907;75;55,731027;9,833955;1866;1939;73
1907;85;55,941434;12,268503;1895;1937;42
1907;90;57,562284;9,986481;1891;1967;76
1907;93;57,356497;9,936222;1890;2021;131
1907;96;55,610496;11,586514;1873;1917;44
1907;105;55,92122;9,997713;1894;1923;29
1907;110;55,965642;9,717756;1884;2006;122
1907;126;57,16496;9,729678;1877;1951;74
1907;128;55,512352;11,287189;1866;1930;64
1907;140;55,585667;9,423096;1899;1961;62
1907;142;55,7217;12,543237;1872;1913;41
1907;144;55,673798;12,577517;1891;2021;130
1907;145;55,682456;12,569828;1877;2021;144
1907;151;54,861238;10,73061;1867;1978;111
1907;155;56,557877;8,412895;1887;1976;89
1907;158;54,815811;11,264489;1905;1996;91
1907;160;55,78677;12,495101;1890;1937;47
1907;176;55,460727;9,822756;1880;1960;80
1907;177;56,839448;8,717907;1864;1946;82
1907;180;56,367177;10,746981;1897;1940;43
1907;181;56,483472;10,446191;1903;1932;29
1907;182;56,453059;10,866897;1868;1938;70
1907;188;55,513946;10,178703;1882;1938;56
1907;195;55,9775064;10,1756177;1890;2021;131
1907;205;55,790358;11,464283;1907;1972;65
1907;209;56,633723;10,219662;1884;1914;30
1907;213;56,833601;10,113311;1885;1939;54
1907;215;56,886164;9,836899;1886;2009;123
1907;221;55,664541;12,092211;1907;1930;23
1907;226;56,30839;9,469623;1897;1923;26
1907;236;56,090396;9,758625;1892;2021;129
1907;239;56,572888;9,051158;1907;2021;114
1907;241;56,651494;8,934794;1855;1908;53
1907;242;56,673252;9,014768;1884;1921;37
1907;251;55,4226556;11,5675895;1889;1927;38
1907;257;55,074867;10,467835;1882;1953;71
1907;260;55,110103;10,734595;1867;1930;63
1907;268;56,327852;10,394815;1869;1919;50
1907;270;56,302138;10,477471;1894;2021;127
1907;294;55,471013;9,099652;1865;2021;156
1907;301;55,643464;9,651961;1889;2021;132
1907;308;55,671645;9,5777;1867;1939;72
1907;315;56,552152;9,40118;1868;2021;153
1907;322;54,9748134;12,2737822;1866;2021;155
1907;326;54,934174;9,248837;1905;1951;46
1907;330;56,92528;10,018117;1866;1908;42
1907;336;56,032176;10,125522;1869;2005;136
1907;340;56,24119;10,199622;1895;1912;17
1907;341;56,262495;10,268877;1875;1920;45
1907;346;56,067076;10,134812;1866;2021;155
1907;348;56,1913548;10,2204192;1906;1921;15
1907;13;55,18902;14,96054;1867;2021;154
1907;29;56,328077;10,04661;1876;2021;145
1907;45;57,32226;10,38428;1898;1912;14
1907;47;55,82879;12,15363;1880;1917;37
1907;115;55,88581;12,51109;1905;1958;53
1907;130;55,67057;11,18151;1899;2021;122
1907;137;55,40711;9,55068;1903;1918;15
1907;191;55,1839;11,98427;1867;1947;80
1907;192;55,28643;11,55841;1852;1916;64
1907;202;55,39817;10,3966;1879;1920;41
1907;208;55,74166;11,41925;1865;2021;156
1907;212;56,51632;10,2095;1880;1917;37
1907;227;56,09678;9,58179;1906;1911;5
1907;235;56,14912;9,91448;1868;1939;71
1907;252;55,2722;12,32416;1894;1953;59
1907;253;55,40862;12,1951;1900;1929;29
1907;259;55,06429;10,59102;1889;1910;21
1907;279;56,93435;8,53381;1895;1913;18
1907;290;55,62305;8,36912;1869;1918;49
1907;304;55,72746;9,53248;1879;1942;63
1907;331;56,99987;9,99301;1899;1928;29
1908;6;55,269626;10,11524;1877;2009;132
1908;7;55,325496;10,197316;1906;1976;70
1908;19;57,141564;10,224039;1873;1974;101
1908;34;55,3214857;11,9687601;1891;1987;96
1908;36;55,306751;12,199669;1869;1924;55
1908;44;57,471613;10,410374;1875;1919;44
1908;55;55,242371;10,53961;1866;2021;155
1908;63;54,8625896;11,7333453;1905;1918;13
1908;66;54,790388;11,944494;1878;1937;59
1908;73;55,84433;9,589121;1848;2021;173
1908;75;55,731027;9,833955;1866;1939;73
1908;85;55,941434;12,268503;1895;1937;42
1908;90;57,562284;9,986481;1891;1967;76
1908;93;57,356497;9,936222;1890;2021;131
1908;96;55,610496;11,586514;1873;1917;44
1908;105;55,92122;9,997713;1894;1923;29
1908;110;55,965642;9,717756;1884;2006;122
1908;126;57,16496;9,729678;1877;1951;74
1908;128;55,512352;11,287189;1866;1930;64
1908;140;55,585667;9,423096;1899;1961;62
1908;142;55,7217;12,543237;1872;1913;41
1908;144;55,673798;12,577517;1891;2021;130
1908;145;55,682456;12,569828;1877;2021;144
1908;150;54,940824;10,73053;1908;1917;9
1908;151;54,861238;10,73061;1867;1978;111
1908;155;56,557877;8,412895;1887;1976;89
1908;158;54,815811;11,264489;1905;1996;91
1908;160;55,78677;12,495101;1890;1937;47
1908;176;55,460727;9,822756;1880;1960;80
1908;177;56,839448;8,717907;1864;1946;82
1908;180;56,367177;10,746981;1897;1940;43
1908;181;56,483472;10,446191;1903;1932;29
1908;182;56,453059;10,866897;1868;1938;70
1908;188;55,513946;10,178703;1882;1938;56
1908;195;55,9775064;10,1756177;1890;2021;131
1908;205;55,790358;11,464283;1907;1972;65
1908;209;56,633723;10,219662;1884;1914;30
1908;213;56,833601;10,113311;1885;1939;54
1908;215;56,886164;9,836899;1886;2009;123
1908;221;55,664541;12,092211;1907;1930;23
1908;226;56,30839;9,469623;1897;1923;26
1908;236;56,090396;9,758625;1892;2021;129
1908;239;56,572888;9,051158;1907;2021;114
1908;241;56,651494;8,934794;1855;1908;53
1908;242;56,673252;9,014768;1884;1921;37
1908;251;55,4226556;11,5675895;1889;1927;38
1908;257;55,074867;10,467835;1882;1953;71
1908;260;55,110103;10,734595;1867;1930;63
1908;268;56,327852;10,394815;1869;1919;50
1908;270;56,302138;10,477471;1894;2021;127
1908;294;55,471013;9,099652;1865;2021;156
1908;301;55,643464;9,651961;1889;2021;132
1908;308;55,671645;9,5777;1867;1939;72
1908;315;56,552152;9,40118;1868;2021;153
1908;322;54,9748134;12,2737822;1866;2021;155
1908;326;54,934174;9,248837;1905;1951;46
1908;330;56,92528;10,018117;1866;1908;42
1908;336;56,032176;10,125522;1869;2005;136
1908;340;56,24119;10,199622;1895;1912;17
1908;341;56,262495;10,268877;1875;1920;45
1908;346;56,067076;10,134812;1866;2021;155
1908;348;56,1913548;10,2204192;1906;1921;15
1908;13;55,18902;14,96054;1867;2021;154
1908;29;56,328077;10,04661;1876;2021;145
1908;45;57,32226;10,38428;1898;1912;14
1908;47;55,82879;12,15363;1880;1917;37
1908;115;55,88581;12,51109;1905;1958;53
1908;130;55,67057;11,18151;1899;2021;122
1908;137;55,40711;9,55068;1903;1918;15
1908;191;55,1839;11,98427;1867;1947;80
1908;192;55,28643;11,55841;1852;1916;64
1908;202;55,39817;10,3966;1879;1920;41
1908;208;55,74166;11,41925;1865;2021;156
1908;212;56,51632;10,2095;1880;1917;37
1908;227;56,09678;9,58179;1906;1911;5
1908;235;56,14912;9,91448;1868;1939;71
1908;252;55,2722;12,32416;1894;1953;59
1908;253;55,40862;12,1951;1900;1929;29
1908;259;55,06429;10,59102;1889;1910;21
1908;279;56,93435;8,53381;1895;1913;18
1908;290;55,62305;8,36912;1869;1918;49
1908;304;55,72746;9,53248;1879;1942;63
1908;331;56,99987;9,99301;1899;1928;29
1909;6;55,269626;10,11524;1877;2009;132
1909;7;55,325496;10,197316;1906;1976;70
1909;19;57,141564;10,224039;1873;1974;101
1909;34;55,3214857;11,9687601;1891;1987;96
1909;36;55,306751;12,199669;1869;1924;55
1909;44;57,471613;10,410374;1875;1919;44
1909;55;55,242371;10,53961;1866;2021;155
1909;63;54,8625896;11,7333453;1905;1918;13
1909;66;54,790388;11,944494;1878;1937;59
1909;73;55,84433;9,589121;1848;2021;173
1909;75;55,731027;9,833955;1866;1939;73
1909;85;55,941434;12,268503;1895;1937;42
1909;90;57,562284;9,986481;1891;1967;76
1909;93;57,356497;9,936222;1890;2021;131
1909;96;55,610496;11,586514;1873;1917;44
1909;105;55,92122;9,997713;1894;1923;29
1909;110;55,965642;9,717756;1884;2006;122
1909;126;57,16496;9,729678;1877;1951;74
1909;128;55,512352;11,287189;1866;1930;64
1909;140;55,585667;9,423096;1899;1961;62
1909;142;55,7217;12,543237;1872;1913;41
1909;144;55,673798;12,577517;1891;2021;130
1909;145;55,682456;12,569828;1877;2021;144
1909;150;54,940824;10,73053;1908;1917;9
1909;151;54,861238;10,73061;1867;1978;111
1909;155;56,557877;8,412895;1887;1976;89
1909;158;54,815811;11,264489;1905;1996;91
1909;160;55,78677;12,495101;1890;1937;47
1909;167;56,762006;10,189351;1909;1923;14
1909;176;55,460727;9,822756;1880;1960;80
1909;177;56,839448;8,717907;1864;1946;82
1909;180;56,367177;10,746981;1897;1940;43
1909;181;56,483472;10,446191;1903;1932;29
1909;182;56,453059;10,866897;1868;1938;70
1909;188;55,513946;10,178703;1882;1938;56
1909;189;55,308112;10,769456;1909;1912;3
1909;195;55,9775064;10,1756177;1890;2021;131
1909;205;55,790358;11,464283;1907;1972;65
1909;209;56,633723;10,219662;1884;1914;30
1909;213;56,833601;10,113311;1885;1939;54
1909;215;56,886164;9,836899;1886;2009;123
1909;221;55,664541;12,092211;1907;1930;23
1909;226;56,30839;9,469623;1897;1923;26
1909;236;56,090396;9,758625;1892;2021;129
1909;239;56,572888;9,051158;1907;2021;114
1909;242;56,673252;9,014768;1884;1921;37
1909;251;55,4226556;11,5675895;1889;1927;38
1909;257;55,074867;10,467835;1882;1953;71
1909;260;55,110103;10,734595;1867;1930;63
1909;268;56,327852;10,394815;1869;1919;50
1909;270;56,302138;10,477471;1894;2021;127
1909;294;55,471013;9,099652;1865;2021;156
1909;301;55,643464;9,651961;1889;2021;132
1909;308;55,671645;9,5777;1867;1939;72
1909;315;56,552152;9,40118;1868;2021;153
1909;322;54,9748134;12,2737822;1866;2021;155
1909;326;54,934174;9,248837;1905;1951;46
1909;336;56,032176;10,125522;1869;2005;136
1909;340;56,24119;10,199622;1895;1912;17
1909;341;56,262495;10,268877;1875;1920;45
1909;346;56,067076;10,134812;1866;2021;155
1909;348;56,1913548;10,2204192;1906;1921;15
1909;13;55,18902;14,96054;1867;2021;154
1909;29;56,328077;10,04661;1876;2021;145
1909;45;57,32226;10,38428;1898;1912;14
1909;47;55,82879;12,15363;1880;1917;37
1909;115;55,88581;12,51109;1905;1958;53
1909;130;55,67057;11,18151;1899;2021;122
1909;137;55,40711;9,55068;1903;1918;15
1909;191;55,1839;11,98427;1867;1947;80
1909;192;55,28643;11,55841;1852;1916;64
1909;202;55,39817;10,3966;1879;1920;41
1909;208;55,74166;11,41925;1865;2021;156
1909;212;56,51632;10,2095;1880;1917;37
1909;227;56,09678;9,58179;1906;1911;5
1909;235;56,14912;9,91448;1868;1939;71
1909;243;55,3931;11,36045;1909;1973;64
1909;252;55,2722;12,32416;1894;1953;59
1909;253;55,40862;12,1951;1900;1929;29
1909;259;55,06429;10,59102;1889;1910;21
1909;279;56,93435;8,53381;1895;1913;18
1909;290;55,62305;8,36912;1869;1918;49
1909;304;55,72746;9,53248;1879;1942;63
1909;331;56,99987;9,99301;1899;1928;29
1910;6;55,269626;10,11524;1877;2009;132
1910;7;55,325496;10,197316;1906;1976;70
1910;19;57,141564;10,224039;1873;1974;101
1910;34;55,3214857;11,9687601;1891;1987;96
1910;36;55,306751;12,199669;1869;1924;55
1910;44;57,471613;10,410374;1875;1919;44
1910;55;55,242371;10,53961;1866;2021;155
1910;63;54,8625896;11,7333453;1905;1918;13
1910;66;54,790388;11,944494;1878;1937;59
1910;73;55,84433;9,589121;1848;2021;173
1910;75;55,731027;9,833955;1866;1939;73
1910;85;55,941434;12,268503;1895;1937;42
1910;90;57,562284;9,986481;1891;1967;76
1910;93;57,356497;9,936222;1890;2021;131
1910;96;55,610496;11,586514;1873;1917;44
1910;105;55,92122;9,997713;1894;1923;29
1910;110;55,965642;9,717756;1884;2006;122
1910;126;57,16496;9,729678;1877;1951;74
1910;128;55,512352;11,287189;1866;1930;64
1910;140;55,585667;9,423096;1899;1961;62
1910;142;55,7217;12,543237;1872;1913;41
1910;144;55,673798;12,577517;1891;2021;130
1910;145;55,682456;12,569828;1877;2021;144
1910;150;54,940824;10,73053;1908;1917;9
1910;151;54,861238;10,73061;1867;1978;111
1910;155;56,557877;8,412895;1887;1976;89
1910;158;54,815811;11,264489;1905;1996;91
1910;160;55,78677;12,495101;1890;1937;47
1910;167;56,762006;10,189351;1909;1923;14
1910;176;55,460727;9,822756;1880;1960;80
1910;177;56,839448;8,717907;1864;1946;82
1910;180;56,367177;10,746981;1897;1940;43
1910;181;56,483472;10,446191;1903;1932;29
1910;182;56,453059;10,866897;1868;1938;70
1910;188;55,513946;10,178703;1882;1938;56
1910;189;55,308112;10,769456;1909;1912;3
1910;195;55,9775064;10,1756177;1890;2021;131
1910;205;55,790358;11,464283;1907;1972;65
1910;209;56,633723;10,219662;1884;1914;30
1910;213;56,833601;10,113311;1885;1939;54
1910;215;56,886164;9,836899;1886;2009;123
1910;221;55,664541;12,092211;1907;1930;23
1910;226;56,30839;9,469623;1897;1923;26
1910;236;56,090396;9,758625;1892;2021;129
1910;239;56,572888;9,051158;1907;2021;114
1910;242;56,673252;9,014768;1884;1921;37
1910;251;55,4226556;11,5675895;1889;1927;38
1910;257;55,074867;10,467835;1882;1953;71
1910;260;55,110103;10,734595;1867;1930;63
1910;268;56,327852;10,394815;1869;1919;50
1910;270;56,302138;10,477471;1894;2021;127
1910;275;55,059207;9,749632;1910;1920;10
1910;294;55,471013;9,099652;1865;2021;156
1910;301;55,643464;9,651961;1889;2021;132
1910;308;55,671645;9,5777;1867;1939;72
1910;315;56,552152;9,40118;1868;2021;153
1910;322;54,9748134;12,2737822;1866;2021;155
1910;326;54,934174;9,248837;1905;1951;46
1910;336;56,032176;10,125522;1869;2005;136
1910;340;56,24119;10,199622;1895;1912;17
1910;341;56,262495;10,268877;1875;1920;45
1910;346;56,067076;10,134812;1866;2021;155
1910;348;56,1913548;10,2204192;1906;1921;15
1910;13;55,18902;14,96054;1867;2021;154
1910;23;55,48022;8,43888;1910;2012;102
1910;29;56,328077;10,04661;1876;2021;145
1910;45;57,32226;10,38428;1898;1912;14
1910;47;55,82879;12,15363;1880;1917;37
1910;115;55,88581;12,51109;1905;1958;53
1910;130;55,67057;11,18151;1899;2021;122
1910;137;55,40711;9,55068;1903;1918;15
1910;191;55,1839;11,98427;1867;1947;80
1910;192;55,28643;11,55841;1852;1916;64
1910;202;55,39817;10,3966;1879;1920;41
1910;208;55,74166;11,41925;1865;2021;156
1910;212;56,51632;10,2095;1880;1917;37
1910;227;56,09678;9,58179;1906;1911;5
1910;235;56,14912;9,91448;1868;1939;71
1910;243;55,3931;11,36045;1909;1973;64
1910;252;55,2722;12,32416;1894;1953;59
1910;253;55,40862;12,1951;1900;1929;29
1910;259;55,06429;10,59102;1889;1910;21
1910;279;56,93435;8,53381;1895;1913;18
1910;290;55,62305;8,36912;1869;1918;49
1910;304;55,72746;9,53248;1879;1942;63
1910;331;56,99987;9,99301;1899;1928;29
1911;6;55,269626;10,11524;1877;2009;132
1911;7;55,325496;10,197316;1906;1976;70
1911;19;57,141564;10,224039;1873;1974;101
1911;34;55,3214857;11,9687601;1891;1987;96
1911;36;55,306751;12,199669;1869;1924;55
1911;44;57,471613;10,410374;1875;1919;44
1911;55;55,242371;10,53961;1866;2021;155
1911;63;54,8625896;11,7333453;1905;1918;13
1911;66;54,790388;11,944494;1878;1937;59
1911;73;55,84433;9,589121;1848;2021;173
1911;75;55,731027;9,833955;1866;1939;73
1911;85;55,941434;12,268503;1895;1937;42
1911;90;57,562284;9,986481;1891;1967;76
1911;93;57,356497;9,936222;1890;2021;131
1911;96;55,610496;11,586514;1873;1917;44
1911;105;55,92122;9,997713;1894;1923;29
1911;110;55,965642;9,717756;1884;2006;122
1911;126;57,16496;9,729678;1877;1951;74
1911;128;55,512352;11,287189;1866;1930;64
1911;140;55,585667;9,423096;1899;1961;62
1911;142;55,7217;12,543237;1872;1913;41
1911;144;55,673798;12,577517;1891;2021;130
1911;145;55,682456;12,569828;1877;2021;144
1911;150;54,940824;10,73053;1908;1917;9
1911;151;54,861238;10,73061;1867;1978;111
1911;155;56,557877;8,412895;1887;1976;89
1911;158;54,815811;11,264489;1905;1996;91
1911;160;55,78677;12,495101;1890;1937;47
1911;167;56,762006;10,189351;1909;1923;14
1911;176;55,460727;9,822756;1880;1960;80
1911;177;56,839448;8,717907;1864;1946;82
1911;180;56,367177;10,746981;1897;1940;43
1911;181;56,483472;10,446191;1903;1932;29
1911;182;56,453059;10,866897;1868;1938;70
1911;188;55,513946;10,178703;1882;1938;56
1911;189;55,308112;10,769456;1909;1912;3
1911;195;55,9775064;10,1756177;1890;2021;131
1911;205;55,790358;11,464283;1907;1972;65
1911;209;56,633723;10,219662;1884;1914;30
1911;213;56,833601;10,113311;1885;1939;54
1911;215;56,886164;9,836899;1886;2009;123
1911;221;55,664541;12,092211;1907;1930;23
1911;226;56,30839;9,469623;1897;1923;26
1911;236;56,090396;9,758625;1892;2021;129
1911;239;56,572888;9,051158;1907;2021;114
1911;242;56,673252;9,014768;1884;1921;37
1911;251;55,4226556;11,5675895;1889;1927;38
1911;257;55,074867;10,467835;1882;1953;71
1911;260;55,110103;10,734595;1867;1930;63
1911;268;56,327852;10,394815;1869;1919;50
1911;270;56,302138;10,477471;1894;2021;127
1911;275;55,059207;9,749632;1910;1920;10
1911;294;55,471013;9,099652;1865;2021;156
1911;301;55,643464;9,651961;1889;2021;132
1911;308;55,671645;9,5777;1867;1939;72
1911;315;56,552152;9,40118;1868;2021;153
1911;322;54,9748134;12,2737822;1866;2021;155
1911;326;54,934174;9,248837;1905;1951;46
1911;336;56,032176;10,125522;1869;2005;136
1911;340;56,24119;10,199622;1895;1912;17
1911;341;56,262495;10,268877;1875;1920;45
1911;346;56,067076;10,134812;1866;2021;155
1911;348;56,1913548;10,2204192;1906;1921;15
1911;13;55,18902;14,96054;1867;2021;154
1911;23;55,48022;8,43888;1910;2012;102
1911;29;56,328077;10,04661;1876;2021;145
1911;45;57,32226;10,38428;1898;1912;14
1911;47;55,82879;12,15363;1880;1917;37
1911;115;55,88581;12,51109;1905;1958;53
1911;130;55,67057;11,18151;1899;2021;122
1911;137;55,40711;9,55068;1903;1918;15
1911;191;55,1839;11,98427;1867;1947;80
1911;192;55,28643;11,55841;1852;1916;64
1911;202;55,39817;10,3966;1879;1920;41
1911;208;55,74166;11,41925;1865;2021;156
1911;212;56,51632;10,2095;1880;1917;37
1911;227;56,09678;9,58179;1906;1911;5
1911;235;56,14912;9,91448;1868;1939;71
1911;243;55,3931;11,36045;1909;1973;64
1911;252;55,2722;12,32416;1894;1953;59
1911;253;55,40862;12,1951;1900;1929;29
1911;279;56,93435;8,53381;1895;1913;18
1911;290;55,62305;8,36912;1869;1918;49
1911;304;55,72746;9,53248;1879;1942;63
1911;331;56,99987;9,99301;1899;1928;29
1912;6;55,269626;10,11524;1877;2009;132
1912;7;55,325496;10,197316;1906;1976;70
1912;19;57,141564;10,224039;1873;1974;101
1912;34;55,3214857;11,9687601;1891;1987;96
1912;36;55,306751;12,199669;1869;1924;55
1912;44;57,471613;10,410374;1875;1919;44
1912;55;55,242371;10,53961;1866;2021;155
1912;63;54,8625896;11,7333453;1905;1918;13
1912;66;54,790388;11,944494;1878;1937;59
1912;73;55,84433;9,589121;1848;2021;173
1912;75;55,731027;9,833955;1866;1939;73
1912;85;55,941434;12,268503;1895;1937;42
1912;90;57,562284;9,986481;1891;1967;76
1912;93;57,356497;9,936222;1890;2021;131
1912;96;55,610496;11,586514;1873;1917;44
1912;105;55,92122;9,997713;1894;1923;29
1912;110;55,965642;9,717756;1884;2006;122
1912;126;57,16496;9,729678;1877;1951;74
1912;128;55,512352;11,287189;1866;1930;64
1912;140;55,585667;9,423096;1899;1961;62
1912;142;55,7217;12,543237;1872;1913;41
1912;144;55,673798;12,577517;1891;2021;130
1912;145;55,682456;12,569828;1877;2021;144
1912;150;54,940824;10,73053;1908;1917;9
1912;151;54,861238;10,73061;1867;1978;111
1912;155;56,557877;8,412895;1887;1976;89
1912;158;54,815811;11,264489;1905;1996;91
1912;160;55,78677;12,495101;1890;1937;47
1912;167;56,762006;10,189351;1909;1923;14
1912;176;55,460727;9,822756;1880;1960;80
1912;177;56,839448;8,717907;1864;1946;82
1912;180;56,367177;10,746981;1897;1940;43
1912;181;56,483472;10,446191;1903;1932;29
1912;182;56,453059;10,866897;1868;1938;70
1912;188;55,513946;10,178703;1882;1938;56
1912;189;55,308112;10,769456;1909;1912;3
1912;195;55,9775064;10,1756177;1890;2021;131
1912;205;55,790358;11,464283;1907;1972;65
1912;209;56,633723;10,219662;1884;1914;30
1912;213;56,833601;10,113311;1885;1939;54
1912;215;56,886164;9,836899;1886;2009;123
1912;221;55,664541;12,092211;1907;1930;23
1912;226;56,30839;9,469623;1897;1923;26
1912;236;56,090396;9,758625;1892;2021;129
1912;239;56,572888;9,051158;1907;2021;114
1912;242;56,673252;9,014768;1884;1921;37
1912;251;55,4226556;11,5675895;1889;1927;38
1912;257;55,074867;10,467835;1882;1953;71
1912;260;55,110103;10,734595;1867;1930;63
1912;268;56,327852;10,394815;1869;1919;50
1912;270;56,302138;10,477471;1894;2021;127
1912;275;55,059207;9,749632;1910;1920;10
1912;294;55,471013;9,099652;1865;2021;156
1912;301;55,643464;9,651961;1889;2021;132
1912;308;55,671645;9,5777;1867;1939;72
1912;315;56,552152;9,40118;1868;2021;153
1912;322;54,9748134;12,2737822;1866;2021;155
1912;326;54,934174;9,248837;1905;1951;46
1912;336;56,032176;10,125522;1869;2005;136
1912;340;56,24119;10,199622;1895;1912;17
1912;341;56,262495;10,268877;1875;1920;45
1912;346;56,067076;10,134812;1866;2021;155
1912;348;56,1913548;10,2204192;1906;1921;15
1912;13;55,18902;14,96054;1867;2021;154
1912;23;55,48022;8,43888;1910;2012;102
1912;29;56,328077;10,04661;1876;2021;145
1912;45;57,32226;10,38428;1898;1912;14
1912;47;55,82879;12,15363;1880;1917;37
1912;115;55,88581;12,51109;1905;1958;53
1912;130;55,67057;11,18151;1899;2021;122
1912;137;55,40711;9,55068;1903;1918;15
1912;191;55,1839;11,98427;1867;1947;80
1912;192;55,28643;11,55841;1852;1916;64
1912;202;55,39817;10,3966;1879;1920;41
1912;208;55,74166;11,41925;1865;2021;156
1912;212;56,51632;10,2095;1880;1917;37
1912;235;56,14912;9,91448;1868;1939;71
1912;243;55,3931;11,36045;1909;1973;64
1912;252;55,2722;12,32416;1894;1953;59
1912;253;55,40862;12,1951;1900;1929;29
1912;279;56,93435;8,53381;1895;1913;18
1912;290;55,62305;8,36912;1869;1918;49
1912;304;55,72746;9,53248;1879;1942;63
1912;331;56,99987;9,99301;1899;1928;29
1913;6;55,269626;10,11524;1877;2009;132
1913;7;55,325496;10,197316;1906;1976;70
1913;19;57,141564;10,224039;1873;1974;101
1913;34;55,3214857;11,9687601;1891;1987;96
1913;36;55,306751;12,199669;1869;1924;55
1913;44;57,471613;10,410374;1875;1919;44
1913;55;55,242371;10,53961;1866;2021;155
1913;63;54,8625896;11,7333453;1905;1918;13
1913;66;54,790388;11,944494;1878;1937;59
1913;73;55,84433;9,589121;1848;2021;173
1913;75;55,731027;9,833955;1866;1939;73
1913;85;55,941434;12,268503;1895;1937;42
1913;90;57,562284;9,986481;1891;1967;76
1913;93;57,356497;9,936222;1890;2021;131
1913;96;55,610496;11,586514;1873;1917;44
1913;105;55,92122;9,997713;1894;1923;29
1913;110;55,965642;9,717756;1884;2006;122
1913;126;57,16496;9,729678;1877;1951;74
1913;128;55,512352;11,287189;1866;1930;64
1913;140;55,585667;9,423096;1899;1961;62
1913;142;55,7217;12,543237;1872;1913;41
1913;144;55,673798;12,577517;1891;2021;130
1913;145;55,682456;12,569828;1877;2021;144
1913;150;54,940824;10,73053;1908;1917;9
1913;151;54,861238;10,73061;1867;1978;111
1913;155;56,557877;8,412895;1887;1976;89
1913;158;54,815811;11,264489;1905;1996;91
1913;160;55,78677;12,495101;1890;1937;47
1913;167;56,762006;10,189351;1909;1923;14
1913;176;55,460727;9,822756;1880;1960;80
1913;177;56,839448;8,717907;1864;1946;82
1913;180;56,367177;10,746981;1897;1940;43
1913;181;56,483472;10,446191;1903;1932;29
1913;182;56,453059;10,866897;1868;1938;70
1913;188;55,513946;10,178703;1882;1938;56
1913;195;55,9775064;10,1756177;1890;2021;131
1913;205;55,790358;11,464283;1907;1972;65
1913;209;56,633723;10,219662;1884;1914;30
1913;213;56,833601;10,113311;1885;1939;54
1913;215;56,886164;9,836899;1886;2009;123
1913;221;55,664541;12,092211;1907;1930;23
1913;226;56,30839;9,469623;1897;1923;26
1913;236;56,090396;9,758625;1892;2021;129
1913;239;56,572888;9,051158;1907;2021;114
1913;242;56,673252;9,014768;1884;1921;37
1913;251;55,4226556;11,5675895;1889;1927;38
1913;257;55,074867;10,467835;1882;1953;71
1913;260;55,110103;10,734595;1867;1930;63
1913;268;56,327852;10,394815;1869;1919;50
1913;270;56,302138;10,477471;1894;2021;127
1913;275;55,059207;9,749632;1910;1920;10
1913;294;55,471013;9,099652;1865;2021;156
1913;301;55,643464;9,651961;1889;2021;132
1913;308;55,671645;9,5777;1867;1939;72
1913;315;56,552152;9,40118;1868;2021;153
1913;322;54,9748134;12,2737822;1866;2021;155
1913;326;54,934174;9,248837;1905;1951;46
1913;336;56,032176;10,125522;1869;2005;136
1913;341;56,262495;10,268877;1875;1920;45
1913;346;56,067076;10,134812;1866;2021;155
1913;348;56,1913548;10,2204192;1906;1921;15
1913;13;55,18902;14,96054;1867;2021;154
1913;23;55,48022;8,43888;1910;2012;102
1913;29;56,328077;10,04661;1876;2021;145
1913;47;55,82879;12,15363;1880;1917;37
1913;115;55,88581;12,51109;1905;1958;53
1913;130;55,67057;11,18151;1899;2021;122
1913;137;55,40711;9,55068;1903;1918;15
1913;191;55,1839;11,98427;1867;1947;80
1913;192;55,28643;11,55841;1852;1916;64
1913;202;55,39817;10,3966;1879;1920;41
1913;208;55,74166;11,41925;1865;2021;156
1913;212;56,51632;10,2095;1880;1917;37
1913;235;56,14912;9,91448;1868;1939;71
1913;243;55,3931;11,36045;1909;1973;64
1913;252;55,2722;12,32416;1894;1953;59
1913;253;55,40862;12,1951;1900;1929;29
1913;279;56,93435;8,53381;1895;1913;18
1913;290;55,62305;8,36912;1869;1918;49
1913;304;55,72746;9,53248;1879;1942;63
1913;331;56,99987;9,99301;1899;1928;29
1914;6;55,269626;10,11524;1877;2009;132
1914;7;55,325496;10,197316;1906;1976;70
1914;19;57,141564;10,224039;1873;1974;101
1914;34;55,3214857;11,9687601;1891;1987;96
1914;36;55,306751;12,199669;1869;1924;55
1914;44;57,471613;10,410374;1875;1919;44
1914;55;55,242371;10,53961;1866;2021;155
1914;63;54,8625896;11,7333453;1905;1918;13
1914;66;54,790388;11,944494;1878;1937;59
1914;73;55,84433;9,589121;1848;2021;173
1914;75;55,731027;9,833955;1866;1939;73
1914;85;55,941434;12,268503;1895;1937;42
1914;90;57,562284;9,986481;1891;1967;76
1914;93;57,356497;9,936222;1890;2021;131
1914;96;55,610496;11,586514;1873;1917;44
1914;105;55,92122;9,997713;1894;1923;29
1914;110;55,965642;9,717756;1884;2006;122
1914;126;57,16496;9,729678;1877;1951;74
1914;128;55,512352;11,287189;1866;1930;64
1914;140;55,585667;9,423096;1899;1961;62
1914;144;55,673798;12,577517;1891;2021;130
1914;145;55,682456;12,569828;1877;2021;144
1914;150;54,940824;10,73053;1908;1917;9
1914;151;54,861238;10,73061;1867;1978;111
1914;155;56,557877;8,412895;1887;1976;89
1914;158;54,815811;11,264489;1905;1996;91
1914;160;55,78677;12,495101;1890;1937;47
1914;167;56,762006;10,189351;1909;1923;14
1914;176;55,460727;9,822756;1880;1960;80
1914;177;56,839448;8,717907;1864;1946;82
1914;180;56,367177;10,746981;1897;1940;43
1914;181;56,483472;10,446191;1903;1932;29
1914;182;56,453059;10,866897;1868;1938;70
1914;188;55,513946;10,178703;1882;1938;56
1914;195;55,9775064;10,1756177;1890;2021;131
1914;205;55,790358;11,464283;1907;1972;65
1914;209;56,633723;10,219662;1884;1914;30
1914;213;56,833601;10,113311;1885;1939;54
1914;215;56,886164;9,836899;1886;2009;123
1914;221;55,664541;12,092211;1907;1930;23
1914;226;56,30839;9,469623;1897;1923;26
1914;236;56,090396;9,758625;1892;2021;129
1914;239;56,572888;9,051158;1907;2021;114
1914;242;56,673252;9,014768;1884;1921;37
1914;251;55,4226556;11,5675895;1889;1927;38
1914;257;55,074867;10,467835;1882;1953;71
1914;260;55,110103;10,734595;1867;1930;63
1914;268;56,327852;10,394815;1869;1919;50
1914;270;56,302138;10,477471;1894;2021;127
1914;275;55,059207;9,749632;1910;1920;10
1914;294;55,471013;9,099652;1865;2021;156
1914;301;55,643464;9,651961;1889;2021;132
1914;308;55,671645;9,5777;1867;1939;72
1914;315;56,552152;9,40118;1868;2021;153
1914;322;54,9748134;12,2737822;1866;2021;155
1914;326;54,934174;9,248837;1905;1951;46
1914;336;56,032176;10,125522;1869;2005;136
1914;341;56,262495;10,268877;1875;1920;45
1914;346;56,067076;10,134812;1866;2021;155
1914;348;56,1913548;10,2204192;1906;1921;15
1914;13;55,18902;14,96054;1867;2021;154
1914;23;55,48022;8,43888;1910;2012;102
1914;29;56,328077;10,04661;1876;2021;145
1914;47;55,82879;12,15363;1880;1917;37
1914;115;55,88581;12,51109;1905;1958;53
1914;130;55,67057;11,18151;1899;2021;122
1914;137;55,40711;9,55068;1903;1918;15
1914;191;55,1839;11,98427;1867;1947;80
1914;192;55,28643;11,55841;1852;1916;64
1914;202;55,39817;10,3966;1879;1920;41
1914;208;55,74166;11,41925;1865;2021;156
1914;212;56,51632;10,2095;1880;1917;37
1914;235;56,14912;9,91448;1868;1939;71
1914;243;55,3931;11,36045;1909;1973;64
1914;252;55,2722;12,32416;1894;1953;59
1914;253;55,40862;12,1951;1900;1929;29
1914;290;55,62305;8,36912;1869;1918;49
1914;304;55,72746;9,53248;1879;1942;63
1914;331;56,99987;9,99301;1899;1928;29
1915;6;55,269626;10,11524;1877;2009;132
1915;7;55,325496;10,197316;1906;1976;70
1915;19;57,141564;10,224039;1873;1974;101
1915;34;55,3214857;11,9687601;1891;1987;96
1915;36;55,306751;12,199669;1869;1924;55
1915;44;57,471613;10,410374;1875;1919;44
1915;55;55,242371;10,53961;1866;2021;155
1915;63;54,8625896;11,7333453;1905;1918;13
1915;66;54,790388;11,944494;1878;1937;59
1915;73;55,84433;9,589121;1848;2021;173
1915;75;55,731027;9,833955;1866;1939;73
1915;85;55,941434;12,268503;1895;1937;42
1915;90;57,562284;9,986481;1891;1967;76
1915;93;57,356497;9,936222;1890;2021;131
1915;96;55,610496;11,586514;1873;1917;44
1915;105;55,92122;9,997713;1894;1923;29
1915;110;55,965642;9,717756;1884;2006;122
1915;126;57,16496;9,729678;1877;1951;74
1915;128;55,512352;11,287189;1866;1930;64
1915;140;55,585667;9,423096;1899;1961;62
1915;144;55,673798;12,577517;1891;2021;130
1915;145;55,682456;12,569828;1877;2021;144
1915;150;54,940824;10,73053;1908;1917;9
1915;151;54,861238;10,73061;1867;1978;111
1915;155;56,557877;8,412895;1887;1976;89
1915;158;54,815811;11,264489;1905;1996;91
1915;160;55,78677;12,495101;1890;1937;47
1915;167;56,762006;10,189351;1909;1923;14
1915;176;55,460727;9,822756;1880;1960;80
1915;177;56,839448;8,717907;1864;1946;82
1915;180;56,367177;10,746981;1897;1940;43
1915;181;56,483472;10,446191;1903;1932;29
1915;182;56,453059;10,866897;1868;1938;70
1915;188;55,513946;10,178703;1882;1938;56
1915;195;55,9775064;10,1756177;1890;2021;131
1915;205;55,790358;11,464283;1907;1972;65
1915;213;56,833601;10,113311;1885;1939;54
1915;215;56,886164;9,836899;1886;2009;123
1915;221;55,664541;12,092211;1907;1930;23
1915;226;56,30839;9,469623;1897;1923;26
1915;236;56,090396;9,758625;1892;2021;129
1915;239;56,572888;9,051158;1907;2021;114
1915;242;56,673252;9,014768;1884;1921;37
1915;251;55,4226556;11,5675895;1889;1927;38
1915;257;55,074867;10,467835;1882;1953;71
1915;260;55,110103;10,734595;1867;1930;63
1915;268;56,327852;10,394815;1869;1919;50
1915;270;56,302138;10,477471;1894;2021;127
1915;275;55,059207;9,749632;1910;1920;10
1915;294;55,471013;9,099652;1865;2021;156
1915;301;55,643464;9,651961;1889;2021;132
1915;308;55,671645;9,5777;1867;1939;72
1915;315;56,552152;9,40118;1868;2021;153
1915;322;54,9748134;12,2737822;1866;2021;155
1915;326;54,934174;9,248837;1905;1951;46
1915;333;57,005237;9,774809;1915;1990;75
1915;336;56,032176;10,125522;1869;2005;136
1915;341;56,262495;10,268877;1875;1920;45
1915;346;56,067076;10,134812;1866;2021;155
1915;348;56,1913548;10,2204192;1906;1921;15
1915;13;55,18902;14,96054;1867;2021;154
1915;23;55,48022;8,43888;1910;2012;102
1915;29;56,328077;10,04661;1876;2021;145
1915;47;55,82879;12,15363;1880;1917;37
1915;115;55,88581;12,51109;1905;1958;53
1915;130;55,67057;11,18151;1899;2021;122
1915;137;55,40711;9,55068;1903;1918;15
1915;191;55,1839;11,98427;1867;1947;80
1915;192;55,28643;11,55841;1852;1916;64
1915;202;55,39817;10,3966;1879;1920;41
1915;208;55,74166;11,41925;1865;2021;156
1915;212;56,51632;10,2095;1880;1917;37
1915;235;56,14912;9,91448;1868;1939;71
1915;243;55,3931;11,36045;1909;1973;64
1915;252;55,2722;12,32416;1894;1953;59
1915;253;55,40862;12,1951;1900;1929;29
1915;290;55,62305;8,36912;1869;1918;49
1915;304;55,72746;9,53248;1879;1942;63
1915;331;56,99987;9,99301;1899;1928;29
1916;6;55,269626;10,11524;1877;2009;132
1916;7;55,325496;10,197316;1906;1976;70
1916;19;57,141564;10,224039;1873;1974;101
1916;34;55,3214857;11,9687601;1891;1987;96
1916;36;55,306751;12,199669;1869;1924;55
1916;44;57,471613;10,410374;1875;1919;44
1916;55;55,242371;10,53961;1866;2021;155
1916;63;54,8625896;11,7333453;1905;1918;13
1916;66;54,790388;11,944494;1878;1937;59
1916;73;55,84433;9,589121;1848;2021;173
1916;75;55,731027;9,833955;1866;1939;73
1916;85;55,941434;12,268503;1895;1937;42
1916;90;57,562284;9,986481;1891;1967;76
1916;93;57,356497;9,936222;1890;2021;131
1916;96;55,610496;11,586514;1873;1917;44
1916;105;55,92122;9,997713;1894;1923;29
1916;110;55,965642;9,717756;1884;2006;122
1916;126;57,16496;9,729678;1877;1951;74
1916;128;55,512352;11,287189;1866;1930;64
1916;140;55,585667;9,423096;1899;1961;62
1916;144;55,673798;12,577517;1891;2021;130
1916;145;55,682456;12,569828;1877;2021;144
1916;150;54,940824;10,73053;1908;1917;9
1916;151;54,861238;10,73061;1867;1978;111
1916;155;56,557877;8,412895;1887;1976;89
1916;158;54,815811;11,264489;1905;1996;91
1916;160;55,78677;12,495101;1890;1937;47
1916;167;56,762006;10,189351;1909;1923;14
1916;176;55,460727;9,822756;1880;1960;80
1916;177;56,839448;8,717907;1864;1946;82
1916;180;56,367177;10,746981;1897;1940;43
1916;181;56,483472;10,446191;1903;1932;29
1916;182;56,453059;10,866897;1868;1938;70
1916;188;55,513946;10,178703;1882;1938;56
1916;195;55,9775064;10,1756177;1890;2021;131
1916;205;55,790358;11,464283;1907;1972;65
1916;213;56,833601;10,113311;1885;1939;54
1916;215;56,886164;9,836899;1886;2009;123
1916;221;55,664541;12,092211;1907;1930;23
1916;226;56,30839;9,469623;1897;1923;26
1916;236;56,090396;9,758625;1892;2021;129
1916;239;56,572888;9,051158;1907;2021;114
1916;242;56,673252;9,014768;1884;1921;37
1916;251;55,4226556;11,5675895;1889;1927;38
1916;257;55,074867;10,467835;1882;1953;71
1916;260;55,110103;10,734595;1867;1930;63
1916;268;56,327852;10,394815;1869;1919;50
1916;270;56,302138;10,477471;1894;2021;127
1916;275;55,059207;9,749632;1910;1920;10
1916;294;55,471013;9,099652;1865;2021;156
1916;301;55,643464;9,651961;1889;2021;132
1916;308;55,671645;9,5777;1867;1939;72
1916;315;56,552152;9,40118;1868;2021;153
1916;322;54,9748134;12,2737822;1866;2021;155
1916;326;54,934174;9,248837;1905;1951;46
1916;333;57,005237;9,774809;1915;1990;75
1916;336;56,032176;10,125522;1869;2005;136
1916;341;56,262495;10,268877;1875;1920;45
1916;346;56,067076;10,134812;1866;2021;155
1916;348;56,1913548;10,2204192;1906;1921;15
1916;13;55,18902;14,96054;1867;2021;154
1916;23;55,48022;8,43888;1910;2012;102
1916;29;56,328077;10,04661;1876;2021;145
1916;47;55,82879;12,15363;1880;1917;37
1916;115;55,88581;12,51109;1905;1958;53
1916;130;55,67057;11,18151;1899;2021;122
1916;137;55,40711;9,55068;1903;1918;15
1916;191;55,1839;11,98427;1867;1947;80
1916;192;55,28643;11,55841;1852;1916;64
1916;202;55,39817;10,3966;1879;1920;41
1916;208;55,74166;11,41925;1865;2021;156
1916;212;56,51632;10,2095;1880;1917;37
1916;235;56,14912;9,91448;1868;1939;71
1916;243;55,3931;11,36045;1909;1973;64
1916;252;55,2722;12,32416;1894;1953;59
1916;253;55,40862;12,1951;1900;1929;29
1916;290;55,62305;8,36912;1869;1918;49
1916;304;55,72746;9,53248;1879;1942;63
1916;331;56,99987;9,99301;1899;1928;29
1917;6;55,269626;10,11524;1877;2009;132
1917;7;55,325496;10,197316;1906;1976;70
1917;19;57,141564;10,224039;1873;1974;101
1917;34;55,3214857;11,9687601;1891;1987;96
1917;36;55,306751;12,199669;1869;1924;55
1917;44;57,471613;10,410374;1875;1919;44
1917;55;55,242371;10,53961;1866;2021;155
1917;63;54,8625896;11,7333453;1905;1918;13
1917;66;54,790388;11,944494;1878;1937;59
1917;73;55,84433;9,589121;1848;2021;173
1917;75;55,731027;9,833955;1866;1939;73
1917;85;55,941434;12,268503;1895;1937;42
1917;90;57,562284;9,986481;1891;1967;76
1917;93;57,356497;9,936222;1890;2021;131
1917;96;55,610496;11,586514;1873;1917;44
1917;105;55,92122;9,997713;1894;1923;29
1917;110;55,965642;9,717756;1884;2006;122
1917;126;57,16496;9,729678;1877;1951;74
1917;128;55,512352;11,287189;1866;1930;64
1917;140;55,585667;9,423096;1899;1961;62
1917;144;55,673798;12,577517;1891;2021;130
1917;145;55,682456;12,569828;1877;2021;144
1917;150;54,940824;10,73053;1908;1917;9
1917;151;54,861238;10,73061;1867;1978;111
1917;155;56,557877;8,412895;1887;1976;89
1917;158;54,815811;11,264489;1905;1996;91
1917;160;55,78677;12,495101;1890;1937;47
1917;167;56,762006;10,189351;1909;1923;14
1917;176;55,460727;9,822756;1880;1960;80
1917;177;56,839448;8,717907;1864;1946;82
1917;180;56,367177;10,746981;1897;1940;43
1917;181;56,483472;10,446191;1903;1932;29
1917;182;56,453059;10,866897;1868;1938;70
1917;188;55,513946;10,178703;1882;1938;56
1917;195;55,9775064;10,1756177;1890;2021;131
1917;205;55,790358;11,464283;1907;1972;65
1917;213;56,833601;10,113311;1885;1939;54
1917;215;56,886164;9,836899;1886;2009;123
1917;221;55,664541;12,092211;1907;1930;23
1917;226;56,30839;9,469623;1897;1923;26
1917;236;56,090396;9,758625;1892;2021;129
1917;239;56,572888;9,051158;1907;2021;114
1917;242;56,673252;9,014768;1884;1921;37
1917;251;55,4226556;11,5675895;1889;1927;38
1917;257;55,074867;10,467835;1882;1953;71
1917;260;55,110103;10,734595;1867;1930;63
1917;268;56,327852;10,394815;1869;1919;50
1917;270;56,302138;10,477471;1894;2021;127
1917;275;55,059207;9,749632;1910;1920;10
1917;294;55,471013;9,099652;1865;2021;156
1917;301;55,643464;9,651961;1889;2021;132
1917;308;55,671645;9,5777;1867;1939;72
1917;315;56,552152;9,40118;1868;2021;153
1917;322;54,9748134;12,2737822;1866;2021;155
1917;326;54,934174;9,248837;1905;1951;46
1917;333;57,005237;9,774809;1915;1990;75
1917;336;56,032176;10,125522;1869;2005;136
1917;341;56,262495;10,268877;1875;1920;45
1917;346;56,067076;10,134812;1866;2021;155
1917;348;56,1913548;10,2204192;1906;1921;15
1917;13;55,18902;14,96054;1867;2021;154
1917;23;55,48022;8,43888;1910;2012;102
1917;29;56,328077;10,04661;1876;2021;145
1917;47;55,82879;12,15363;1880;1917;37
1917;115;55,88581;12,51109;1905;1958;53
1917;130;55,67057;11,18151;1899;2021;122
1917;137;55,40711;9,55068;1903;1918;15
1917;191;55,1839;11,98427;1867;1947;80
1917;202;55,39817;10,3966;1879;1920;41
1917;208;55,74166;11,41925;1865;2021;156
1917;212;56,51632;10,2095;1880;1917;37
1917;235;56,14912;9,91448;1868;1939;71
1917;243;55,3931;11,36045;1909;1973;64
1917;252;55,2722;12,32416;1894;1953;59
1917;253;55,40862;12,1951;1900;1929;29
1917;290;55,62305;8,36912;1869;1918;49
1917;304;55,72746;9,53248;1879;1942;63
1917;331;56,99987;9,99301;1899;1928;29
1918;6;55,269626;10,11524;1877;2009;132
1918;7;55,325496;10,197316;1906;1976;70
1918;19;57,141564;10,224039;1873;1974;101
1918;34;55,3214857;11,9687601;1891;1987;96
1918;36;55,306751;12,199669;1869;1924;55
1918;44;57,471613;10,410374;1875;1919;44
1918;55;55,242371;10,53961;1866;2021;155
1918;63;54,8625896;11,7333453;1905;1918;13
1918;66;54,790388;11,944494;1878;1937;59
1918;73;55,84433;9,589121;1848;2021;173
1918;75;55,731027;9,833955;1866;1939;73
1918;85;55,941434;12,268503;1895;1937;42
1918;90;57,562284;9,986481;1891;1967;76
1918;93;57,356497;9,936222;1890;2021;131
1918;105;55,92122;9,997713;1894;1923;29
1918;110;55,965642;9,717756;1884;2006;122
1918;126;57,16496;9,729678;1877;1951;74
1918;128;55,512352;11,287189;1866;1930;64
1918;140;55,585667;9,423096;1899;1961;62
1918;144;55,673798;12,577517;1891;2021;130
1918;145;55,682456;12,569828;1877;2021;144
1918;151;54,861238;10,73061;1867;1978;111
1918;155;56,557877;8,412895;1887;1976;89
1918;158;54,815811;11,264489;1905;1996;91
1918;160;55,78677;12,495101;1890;1937;47
1918;167;56,762006;10,189351;1909;1923;14
1918;176;55,460727;9,822756;1880;1960;80
1918;177;56,839448;8,717907;1864;1946;82
1918;180;56,367177;10,746981;1897;1940;43
1918;181;56,483472;10,446191;1903;1932;29
1918;182;56,453059;10,866897;1868;1938;70
1918;188;55,513946;10,178703;1882;1938;56
1918;195;55,9775064;10,1756177;1890;2021;131
1918;205;55,790358;11,464283;1907;1972;65
1918;213;56,833601;10,113311;1885;1939;54
1918;215;56,886164;9,836899;1886;2009;123
1918;221;55,664541;12,092211;1907;1930;23
1918;226;56,30839;9,469623;1897;1923;26
1918;236;56,090396;9,758625;1892;2021;129
1918;239;56,572888;9,051158;1907;2021;114
1918;242;56,673252;9,014768;1884;1921;37
1918;251;55,4226556;11,5675895;1889;1927;38
1918;257;55,074867;10,467835;1882;1953;71
1918;260;55,110103;10,734595;1867;1930;63
1918;268;56,327852;10,394815;1869;1919;50
1918;270;56,302138;10,477471;1894;2021;127
1918;275;55,059207;9,749632;1910;1920;10
1918;294;55,471013;9,099652;1865;2021;156
1918;301;55,643464;9,651961;1889;2021;132
1918;308;55,671645;9,5777;1867;1939;72
1918;315;56,552152;9,40118;1868;2021;153
1918;322;54,9748134;12,2737822;1866;2021;155
1918;326;54,934174;9,248837;1905;1951;46
1918;333;57,005237;9,774809;1915;1990;75
1918;336;56,032176;10,125522;1869;2005;136
1918;341;56,262495;10,268877;1875;1920;45
1918;346;56,067076;10,134812;1866;2021;155
1918;348;56,1913548;10,2204192;1906;1921;15
1918;13;55,18902;14,96054;1867;2021;154
1918;23;55,48022;8,43888;1910;2012;102
1918;29;56,328077;10,04661;1876;2021;145
1918;115;55,88581;12,51109;1905;1958;53
1918;130;55,67057;11,18151;1899;2021;122
1918;137;55,40711;9,55068;1903;1918;15
1918;191;55,1839;11,98427;1867;1947;80
1918;202;55,39817;10,3966;1879;1920;41
1918;208;55,74166;11,41925;1865;2021;156
1918;235;56,14912;9,91448;1868;1939;71
1918;243;55,3931;11,36045;1909;1973;64
1918;252;55,2722;12,32416;1894;1953;59
1918;253;55,40862;12,1951;1900;1929;29
1918;290;55,62305;8,36912;1869;1918;49
1918;304;55,72746;9,53248;1879;1942;63
1918;331;56,99987;9,99301;1899;1928;29
1919;6;55,269626;10,11524;1877;2009;132
1919;7;55,325496;10,197316;1906;1976;70
1919;19;57,141564;10,224039;1873;1974;101
1919;34;55,3214857;11,9687601;1891;1987;96
1919;36;55,306751;12,199669;1869;1924;55
1919;44;57,471613;10,410374;1875;1919;44
1919;55;55,242371;10,53961;1866;2021;155
1919;66;54,790388;11,944494;1878;1937;59
1919;73;55,84433;9,589121;1848;2021;173
1919;75;55,731027;9,833955;1866;1939;73
1919;85;55,941434;12,268503;1895;1937;42
1919;90;57,562284;9,986481;1891;1967;76
1919;93;57,356497;9,936222;1890;2021;131
1919;105;55,92122;9,997713;1894;1923;29
1919;110;55,965642;9,717756;1884;2006;122
1919;126;57,16496;9,729678;1877;1951;74
1919;128;55,512352;11,287189;1866;1930;64
1919;140;55,585667;9,423096;1899;1961;62
1919;144;55,673798;12,577517;1891;2021;130
1919;145;55,682456;12,569828;1877;2021;144
1919;151;54,861238;10,73061;1867;1978;111
1919;155;56,557877;8,412895;1887;1976;89
1919;158;54,815811;11,264489;1905;1996;91
1919;160;55,78677;12,495101;1890;1937;47
1919;167;56,762006;10,189351;1909;1923;14
1919;176;55,460727;9,822756;1880;1960;80
1919;177;56,839448;8,717907;1864;1946;82
1919;180;56,367177;10,746981;1897;1940;43
1919;181;56,483472;10,446191;1903;1932;29
1919;182;56,453059;10,866897;1868;1938;70
1919;188;55,513946;10,178703;1882;1938;56
1919;195;55,9775064;10,1756177;1890;2021;131
1919;205;55,790358;11,464283;1907;1972;65
1919;213;56,833601;10,113311;1885;1939;54
1919;215;56,886164;9,836899;1886;2009;123
1919;221;55,664541;12,092211;1907;1930;23
1919;226;56,30839;9,469623;1897;1923;26
1919;236;56,090396;9,758625;1892;2021;129
1919;239;56,572888;9,051158;1907;2021;114
1919;242;56,673252;9,014768;1884;1921;37
1919;251;55,4226556;11,5675895;1889;1927;38
1919;257;55,074867;10,467835;1882;1953;71
1919;260;55,110103;10,734595;1867;1930;63
1919;268;56,327852;10,394815;1869;1919;50
1919;270;56,302138;10,477471;1894;2021;127
1919;275;55,059207;9,749632;1910;1920;10
1919;294;55,471013;9,099652;1865;2021;156
1919;301;55,643464;9,651961;1889;2021;132
1919;308;55,671645;9,5777;1867;1939;72
1919;315;56,552152;9,40118;1868;2021;153
1919;322;54,9748134;12,2737822;1866;2021;155
1919;326;54,934174;9,248837;1905;1951;46
1919;333;57,005237;9,774809;1915;1990;75
1919;336;56,032176;10,125522;1869;2005;136
1919;341;56,262495;10,268877;1875;1920;45
1919;346;56,067076;10,134812;1866;2021;155
1919;348;56,1913548;10,2204192;1906;1921;15
1919;13;55,18902;14,96054;1867;2021;154
1919;23;55,48022;8,43888;1910;2012;102
1919;29;56,328077;10,04661;1876;2021;145
1919;115;55,88581;12,51109;1905;1958;53
1919;130;55,67057;11,18151;1899;2021;122
1919;191;55,1839;11,98427;1867;1947;80
1919;202;55,39817;10,3966;1879;1920;41
1919;208;55,74166;11,41925;1865;2021;156
1919;235;56,14912;9,91448;1868;1939;71
1919;243;55,3931;11,36045;1909;1973;64
1919;252;55,2722;12,32416;1894;1953;59
1919;253;55,40862;12,1951;1900;1929;29
1919;304;55,72746;9,53248;1879;1942;63
1919;331;56,99987;9,99301;1899;1928;29
1920;6;55,269626;10,11524;1877;2009;132
1920;7;55,325496;10,197316;1906;1976;70
1920;19;57,141564;10,224039;1873;1974;101
1920;34;55,3214857;11,9687601;1891;1987;96
1920;35;55,3225039;11,9608428;1920;2010;90
1920;36;55,306751;12,199669;1869;1924;55
1920;55;55,242371;10,53961;1866;2021;155
1920;66;54,790388;11,944494;1878;1937;59
1920;69;55,182844;9,45901;1920;2004;84
1920;73;55,84433;9,589121;1848;2021;173
1920;75;55,731027;9,833955;1866;1939;73
1920;85;55,941434;12,268503;1895;1937;42
1920;90;57,562284;9,986481;1891;1967;76
1920;93;57,356497;9,936222;1890;2021;131
1920;105;55,92122;9,997713;1894;1923;29
1920;110;55,965642;9,717756;1884;2006;122
1920;126;57,16496;9,729678;1877;1951;74
1920;128;55,512352;11,287189;1866;1930;64
1920;140;55,585667;9,423096;1899;1961;62
1920;144;55,673798;12,577517;1891;2021;130
1920;145;55,682456;12,569828;1877;2021;144
1920;151;54,861238;10,73061;1867;1978;111
1920;155;56,557877;8,412895;1887;1976;89
1920;158;54,815811;11,264489;1905;1996;91
1920;160;55,78677;12,495101;1890;1937;47
1920;167;56,762006;10,189351;1909;1923;14
1920;176;55,460727;9,822756;1880;1960;80
1920;177;56,839448;8,717907;1864;1946;82
1920;180;56,367177;10,746981;1897;1940;43
1920;181;56,483472;10,446191;1903;1932;29
1920;182;56,453059;10,866897;1868;1938;70
1920;188;55,513946;10,178703;1882;1938;56
1920;195;55,9775064;10,1756177;1890;2021;131
1920;205;55,790358;11,464283;1907;1972;65
1920;213;56,833601;10,113311;1885;1939;54
1920;215;56,886164;9,836899;1886;2009;123
1920;221;55,664541;12,092211;1907;1930;23
1920;226;56,30839;9,469623;1897;1923;26
1920;236;56,090396;9,758625;1892;2021;129
1920;239;56,572888;9,051158;1907;2021;114
1920;242;56,673252;9,014768;1884;1921;37
1920;251;55,4226556;11,5675895;1889;1927;38
1920;256;55,070962;10,511664;1920;2021;101
1920;257;55,074867;10,467835;1882;1953;71
1920;260;55,110103;10,734595;1867;1930;63
1920;270;56,302138;10,477471;1894;2021;127
1920;271;54,986632;9,977204;1920;2002;82
1920;275;55,059207;9,749632;1910;1920;10
1920;294;55,471013;9,099652;1865;2021;156
1920;301;55,643464;9,651961;1889;2021;132
1920;308;55,671645;9,5777;1867;1939;72
1920;315;56,552152;9,40118;1868;2021;153
1920;322;54,9748134;12,2737822;1866;2021;155
1920;326;54,934174;9,248837;1905;1951;46
1920;333;57,005237;9,774809;1915;1990;75
1920;336;56,032176;10,125522;1869;2005;136
1920;341;56,262495;10,268877;1875;1920;45
1920;346;56,067076;10,134812;1866;2021;155
1920;348;56,1913548;10,2204192;1906;1921;15
1920;13;55,18902;14,96054;1867;2021;154
1920;23;55,48022;8,43888;1910;2012;102
1920;29;56,328077;10,04661;1876;2021;145
1920;115;55,88581;12,51109;1905;1958;53
1920;130;55,67057;11,18151;1899;2021;122
1920;191;55,1839;11,98427;1867;1947;80
1920;202;55,39817;10,3966;1879;1920;41
1920;208;55,74166;11,41925;1865;2021;156
1920;235;56,14912;9,91448;1868;1939;71
1920;243;55,3931;11,36045;1909;1973;64
1920;252;55,2722;12,32416;1894;1953;59
1920;253;55,40862;12,1951;1900;1929;29
1920;304;55,72746;9,53248;1879;1942;63
1920;331;56,99987;9,99301;1899;1928;29
1921;6;55,269626;10,11524;1877;2009;132
1921;7;55,325496;10,197316;1906;1976;70
1921;19;57,141564;10,224039;1873;1974;101
1921;34;55,3214857;11,9687601;1891;1987;96
1921;35;55,3225039;11,9608428;1920;2010;90
1921;36;55,306751;12,199669;1869;1924;55
1921;55;55,242371;10,53961;1866;2021;155
1921;66;54,790388;11,944494;1878;1937;59
1921;69;55,182844;9,45901;1920;2004;84
1921;73;55,84433;9,589121;1848;2021;173
1921;75;55,731027;9,833955;1866;1939;73
1921;77;56,028439;12,589834;1921;2021;100
1921;85;55,941434;12,268503;1895;1937;42
1921;90;57,562284;9,986481;1891;1967;76
1921;93;57,356497;9,936222;1890;2021;131
1921;105;55,92122;9,997713;1894;1923;29
1921;110;55,965642;9,717756;1884;2006;122
1921;126;57,16496;9,729678;1877;1951;74
1921;128;55,512352;11,287189;1866;1930;64
1921;140;55,585667;9,423096;1899;1961;62
1921;144;55,673798;12,577517;1891;2021;130
1921;145;55,682456;12,569828;1877;2021;144
1921;151;54,861238;10,73061;1867;1978;111
1921;155;56,557877;8,412895;1887;1976;89
1921;158;54,815811;11,264489;1905;1996;91
1921;160;55,78677;12,495101;1890;1937;47
1921;167;56,762006;10,189351;1909;1923;14
1921;176;55,460727;9,822756;1880;1960;80
1921;177;56,839448;8,717907;1864;1946;82
1921;180;56,367177;10,746981;1897;1940;43
1921;181;56,483472;10,446191;1903;1932;29
1921;182;56,453059;10,866897;1868;1938;70
1921;188;55,513946;10,178703;1882;1938;56
1921;195;55,9775064;10,1756177;1890;2021;131
1921;205;55,790358;11,464283;1907;1972;65
1921;213;56,833601;10,113311;1885;1939;54
1921;215;56,886164;9,836899;1886;2009;123
1921;221;55,664541;12,092211;1907;1930;23
1921;226;56,30839;9,469623;1897;1923;26
1921;236;56,090396;9,758625;1892;2021;129
1921;239;56,572888;9,051158;1907;2021;114
1921;242;56,673252;9,014768;1884;1921;37
1921;251;55,4226556;11,5675895;1889;1927;38
1921;256;55,070962;10,511664;1920;2021;101
1921;257;55,074867;10,467835;1882;1953;71
1921;260;55,110103;10,734595;1867;1930;63
1921;270;56,302138;10,477471;1894;2021;127
1921;271;54,986632;9,977204;1920;2002;82
1921;294;55,471013;9,099652;1865;2021;156
1921;301;55,643464;9,651961;1889;2021;132
1921;308;55,671645;9,5777;1867;1939;72
1921;315;56,552152;9,40118;1868;2021;153
1921;322;54,9748134;12,2737822;1866;2021;155
1921;326;54,934174;9,248837;1905;1951;46
1921;328;54,873518;9,518945;1921;2021;100
1921;333;57,005237;9,774809;1915;1990;75
1921;336;56,032176;10,125522;1869;2005;136
1921;346;56,067076;10,134812;1866;2021;155
1921;348;56,1913548;10,2204192;1906;1921;15
1921;13;55,18902;14,96054;1867;2021;154
1921;23;55,48022;8,43888;1910;2012;102
1921;28;56,3281;10,04992;1921;1936;15
1921;29;56,328077;10,04661;1876;2021;145
1921;115;55,88581;12,51109;1905;1958;53
1921;130;55,67057;11,18151;1899;2021;122
1921;191;55,1839;11,98427;1867;1947;80
1921;208;55,74166;11,41925;1865;2021;156
1921;235;56,14912;9,91448;1868;1939;71
1921;243;55,3931;11,36045;1909;1973;64
1921;252;55,2722;12,32416;1894;1953;59
1921;253;55,40862;12,1951;1900;1929;29
1921;304;55,72746;9,53248;1879;1942;63
1921;331;56,99987;9,99301;1899;1928;29
1922;6;55,269626;10,11524;1877;2009;132
1922;7;55,325496;10,197316;1906;1976;70
1922;19;57,141564;10,224039;1873;1974;101
1922;34;55,3214857;11,9687601;1891;1987;96
1922;35;55,3225039;11,9608428;1920;2010;90
1922;36;55,306751;12,199669;1869;1924;55
1922;55;55,242371;10,53961;1866;2021;155
1922;66;54,790388;11,944494;1878;1937;59
1922;69;55,182844;9,45901;1920;2004;84
1922;73;55,84433;9,589121;1848;2021;173
1922;75;55,731027;9,833955;1866;1939;73
1922;77;56,028439;12,589834;1921;2021;100
1922;85;55,941434;12,268503;1895;1937;42
1922;90;57,562284;9,986481;1891;1967;76
1922;93;57,356497;9,936222;1890;2021;131
1922;105;55,92122;9,997713;1894;1923;29
1922;110;55,965642;9,717756;1884;2006;122
1922;126;57,16496;9,729678;1877;1951;74
1922;128;55,512352;11,287189;1866;1930;64
1922;140;55,585667;9,423096;1899;1961;62
1922;144;55,673798;12,577517;1891;2021;130
1922;145;55,682456;12,569828;1877;2021;144
1922;151;54,861238;10,73061;1867;1978;111
1922;155;56,557877;8,412895;1887;1976;89
1922;158;54,815811;11,264489;1905;1996;91
1922;160;55,78677;12,495101;1890;1937;47
1922;167;56,762006;10,189351;1909;1923;14
1922;176;55,460727;9,822756;1880;1960;80
1922;177;56,839448;8,717907;1864;1946;82
1922;180;56,367177;10,746981;1897;1940;43
1922;181;56,483472;10,446191;1903;1932;29
1922;182;56,453059;10,866897;1868;1938;70
1922;188;55,513946;10,178703;1882;1938;56
1922;195;55,9775064;10,1756177;1890;2021;131
1922;205;55,790358;11,464283;1907;1972;65
1922;213;56,833601;10,113311;1885;1939;54
1922;215;56,886164;9,836899;1886;2009;123
1922;221;55,664541;12,092211;1907;1930;23
1922;226;56,30839;9,469623;1897;1923;26
1922;236;56,090396;9,758625;1892;2021;129
1922;239;56,572888;9,051158;1907;2021;114
1922;251;55,4226556;11,5675895;1889;1927;38
1922;256;55,070962;10,511664;1920;2021;101
1922;257;55,074867;10,467835;1882;1953;71
1922;260;55,110103;10,734595;1867;1930;63
1922;270;56,302138;10,477471;1894;2021;127
1922;271;54,986632;9,977204;1920;2002;82
1922;294;55,471013;9,099652;1865;2021;156
1922;301;55,643464;9,651961;1889;2021;132
1922;308;55,671645;9,5777;1867;1939;72
1922;315;56,552152;9,40118;1868;2021;153
1922;322;54,9748134;12,2737822;1866;2021;155
1922;326;54,934174;9,248837;1905;1951;46
1922;328;54,873518;9,518945;1921;2021;100
1922;333;57,005237;9,774809;1915;1990;75
1922;336;56,032176;10,125522;1869;2005;136
1922;346;56,067076;10,134812;1866;2021;155
1922;13;55,18902;14,96054;1867;2021;154
1922;23;55,48022;8,43888;1910;2012;102
1922;28;56,3281;10,04992;1921;1936;15
1922;29;56,328077;10,04661;1876;2021;145
1922;115;55,88581;12,51109;1905;1958;53
1922;130;55,67057;11,18151;1899;2021;122
1922;191;55,1839;11,98427;1867;1947;80
1922;208;55,74166;11,41925;1865;2021;156
1922;235;56,14912;9,91448;1868;1939;71
1922;243;55,3931;11,36045;1909;1973;64
1922;252;55,2722;12,32416;1894;1953;59
1922;253;55,40862;12,1951;1900;1929;29
1922;304;55,72746;9,53248;1879;1942;63
1922;331;56,99987;9,99301;1899;1928;29
1923;6;55,269626;10,11524;1877;2009;132
1923;7;55,325496;10,197316;1906;1976;70
1923;19;57,141564;10,224039;1873;1974;101
1923;34;55,3214857;11,9687601;1891;1987;96
1923;35;55,3225039;11,9608428;1920;2010;90
1923;36;55,306751;12,199669;1869;1924;55
1923;55;55,242371;10,53961;1866;2021;155
1923;66;54,790388;11,944494;1878;1937;59
1923;69;55,182844;9,45901;1920;2004;84
1923;73;55,84433;9,589121;1848;2021;173
1923;75;55,731027;9,833955;1866;1939;73
1923;77;56,028439;12,589834;1921;2021;100
1923;85;55,941434;12,268503;1895;1937;42
1923;88;55,944946;12,309925;1923;2021;98
1923;90;57,562284;9,986481;1891;1967;76
1923;93;57,356497;9,936222;1890;2021;131
1923;105;55,92122;9,997713;1894;1923;29
1923;110;55,965642;9,717756;1884;2006;122
1923;126;57,16496;9,729678;1877;1951;74
1923;128;55,512352;11,287189;1866;1930;64
1923;140;55,585667;9,423096;1899;1961;62
1923;144;55,673798;12,577517;1891;2021;130
1923;145;55,682456;12,569828;1877;2021;144
1923;151;54,861238;10,73061;1867;1978;111
1923;155;56,557877;8,412895;1887;1976;89
1923;158;54,815811;11,264489;1905;1996;91
1923;160;55,78677;12,495101;1890;1937;47
1923;167;56,762006;10,189351;1909;1923;14
1923;176;55,460727;9,822756;1880;1960;80
1923;177;56,839448;8,717907;1864;1946;82
1923;180;56,367177;10,746981;1897;1940;43
1923;181;56,483472;10,446191;1903;1932;29
1923;182;56,453059;10,866897;1868;1938;70
1923;188;55,513946;10,178703;1882;1938;56
1923;195;55,9775064;10,1756177;1890;2021;131
1923;205;55,790358;11,464283;1907;1972;65
1923;213;56,833601;10,113311;1885;1939;54
1923;215;56,886164;9,836899;1886;2009;123
1923;221;55,664541;12,092211;1907;1930;23
1923;226;56,30839;9,469623;1897;1923;26
1923;236;56,090396;9,758625;1892;2021;129
1923;239;56,572888;9,051158;1907;2021;114
1923;251;55,4226556;11,5675895;1889;1927;38
1923;256;55,070962;10,511664;1920;2021;101
1923;257;55,074867;10,467835;1882;1953;71
1923;260;55,110103;10,734595;1867;1930;63
1923;270;56,302138;10,477471;1894;2021;127
1923;271;54,986632;9,977204;1920;2002;82
1923;294;55,471013;9,099652;1865;2021;156
1923;301;55,643464;9,651961;1889;2021;132
1923;308;55,671645;9,5777;1867;1939;72
1923;315;56,552152;9,40118;1868;2021;153
1923;322;54,9748134;12,2737822;1866;2021;155
1923;326;54,934174;9,248837;1905;1951;46
1923;328;54,873518;9,518945;1921;2021;100
1923;333;57,005237;9,774809;1915;1990;75
1923;336;56,032176;10,125522;1869;2005;136
1923;346;56,067076;10,134812;1866;2021;155
1923;13;55,18902;14,96054;1867;2021;154
1923;23;55,48022;8,43888;1910;2012;102
1923;28;56,3281;10,04992;1921;1936;15
1923;29;56,328077;10,04661;1876;2021;145
1923;115;55,88581;12,51109;1905;1958;53
1923;130;55,67057;11,18151;1899;2021;122
1923;191;55,1839;11,98427;1867;1947;80
1923;208;55,74166;11,41925;1865;2021;156
1923;235;56,14912;9,91448;1868;1939;71
1923;243;55,3931;11,36045;1909;1973;64
1923;252;55,2722;12,32416;1894;1953;59
1923;253;55,40862;12,1951;1900;1929;29
1923;304;55,72746;9,53248;1879;1942;63
1923;331;56,99987;9,99301;1899;1928;29
1924;6;55,269626;10,11524;1877;2009;132
1924;7;55,325496;10,197316;1906;1976;70
1924;19;57,141564;10,224039;1873;1974;101
1924;34;55,3214857;11,9687601;1891;1987;96
1924;35;55,3225039;11,9608428;1920;2010;90
1924;36;55,306751;12,199669;1869;1924;55
1924;55;55,242371;10,53961;1866;2021;155
1924;66;54,790388;11,944494;1878;1937;59
1924;69;55,182844;9,45901;1920;2004;84
1924;73;55,84433;9,589121;1848;2021;173
1924;75;55,731027;9,833955;1866;1939;73
1924;77;56,028439;12,589834;1921;2021;100
1924;85;55,941434;12,268503;1895;1937;42
1924;88;55,944946;12,309925;1923;2021;98
1924;90;57,562284;9,986481;1891;1967;76
1924;93;57,356497;9,936222;1890;2021;131
1924;110;55,965642;9,717756;1884;2006;122
1924;126;57,16496;9,729678;1877;1951;74
1924;128;55,512352;11,287189;1866;1930;64
1924;140;55,585667;9,423096;1899;1961;62
1924;144;55,673798;12,577517;1891;2021;130
1924;145;55,682456;12,569828;1877;2021;144
1924;151;54,861238;10,73061;1867;1978;111
1924;155;56,557877;8,412895;1887;1976;89
1924;158;54,815811;11,264489;1905;1996;91
1924;160;55,78677;12,495101;1890;1937;47
1924;176;55,460727;9,822756;1880;1960;80
1924;177;56,839448;8,717907;1864;1946;82
1924;180;56,367177;10,746981;1897;1940;43
1924;181;56,483472;10,446191;1903;1932;29
1924;182;56,453059;10,866897;1868;1938;70
1924;188;55,513946;10,178703;1882;1938;56
1924;195;55,9775064;10,1756177;1890;2021;131
1924;205;55,790358;11,464283;1907;1972;65
1924;213;56,833601;10,113311;1885;1939;54
1924;215;56,886164;9,836899;1886;2009;123
1924;221;55,664541;12,092211;1907;1930;23
1924;236;56,090396;9,758625;1892;2021;129
1924;239;56,572888;9,051158;1907;2021;114
1924;251;55,4226556;11,5675895;1889;1927;38
1924;256;55,070962;10,511664;1920;2021;101
1924;257;55,074867;10,467835;1882;1953;71
1924;260;55,110103;10,734595;1867;1930;63
1924;270;56,302138;10,477471;1894;2021;127
1924;271;54,986632;9,977204;1920;2002;82
1924;294;55,471013;9,099652;1865;2021;156
1924;301;55,643464;9,651961;1889;2021;132
1924;308;55,671645;9,5777;1867;1939;72
1924;315;56,552152;9,40118;1868;2021;153
1924;322;54,9748134;12,2737822;1866;2021;155
1924;326;54,934174;9,248837;1905;1951;46
1924;328;54,873518;9,518945;1921;2021;100
1924;333;57,005237;9,774809;1915;1990;75
1924;336;56,032176;10,125522;1869;2005;136
1924;346;56,067076;10,134812;1866;2021;155
1924;13;55,18902;14,96054;1867;2021;154
1924;23;55,48022;8,43888;1910;2012;102
1924;28;56,3281;10,04992;1921;1936;15
1924;29;56,328077;10,04661;1876;2021;145
1924;115;55,88581;12,51109;1905;1958;53
1924;130;55,67057;11,18151;1899;2021;122
1924;191;55,1839;11,98427;1867;1947;80
1924;208;55,74166;11,41925;1865;2021;156
1924;235;56,14912;9,91448;1868;1939;71
1924;243;55,3931;11,36045;1909;1973;64
1924;252;55,2722;12,32416;1894;1953;59
1924;253;55,40862;12,1951;1900;1929;29
1924;304;55,72746;9,53248;1879;1942;63
1924;331;56,99987;9,99301;1899;1928;29
1925;6;55,269626;10,11524;1877;2009;132
1925;7;55,325496;10,197316;1906;1976;70
1925;19;57,141564;10,224039;1873;1974;101
1925;34;55,3214857;11,9687601;1891;1987;96
1925;35;55,3225039;11,9608428;1920;2010;90
1925;55;55,242371;10,53961;1866;2021;155
1925;66;54,790388;11,944494;1878;1937;59
1925;69;55,182844;9,45901;1920;2004;84
1925;73;55,84433;9,589121;1848;2021;173
1925;75;55,731027;9,833955;1866;1939;73
1925;77;56,028439;12,589834;1921;2021;100
1925;85;55,941434;12,268503;1895;1937;42
1925;88;55,944946;12,309925;1923;2021;98
1925;90;57,562284;9,986481;1891;1967;76
1925;93;57,356497;9,936222;1890;2021;131
1925;110;55,965642;9,717756;1884;2006;122
1925;126;57,16496;9,729678;1877;1951;74
1925;128;55,512352;11,287189;1866;1930;64
1925;140;55,585667;9,423096;1899;1961;62
1925;144;55,673798;12,577517;1891;2021;130
1925;145;55,682456;12,569828;1877;2021;144
1925;151;54,861238;10,73061;1867;1978;111
1925;155;56,557877;8,412895;1887;1976;89
1925;158;54,815811;11,264489;1905;1996;91
1925;160;55,78677;12,495101;1890;1937;47
1925;176;55,460727;9,822756;1880;1960;80
1925;177;56,839448;8,717907;1864;1946;82
1925;180;56,367177;10,746981;1897;1940;43
1925;181;56,483472;10,446191;1903;1932;29
1925;182;56,453059;10,866897;1868;1938;70
1925;188;55,513946;10,178703;1882;1938;56
1925;195;55,9775064;10,1756177;1890;2021;131
1925;205;55,790358;11,464283;1907;1972;65
1925;213;56,833601;10,113311;1885;1939;54
1925;215;56,886164;9,836899;1886;2009;123
1925;221;55,664541;12,092211;1907;1930;23
1925;236;56,090396;9,758625;1892;2021;129
1925;239;56,572888;9,051158;1907;2021;114
1925;251;55,4226556;11,5675895;1889;1927;38
1925;256;55,070962;10,511664;1920;2021;101
1925;257;55,074867;10,467835;1882;1953;71
1925;260;55,110103;10,734595;1867;1930;63
1925;270;56,302138;10,477471;1894;2021;127
1925;271;54,986632;9,977204;1920;2002;82
1925;294;55,471013;9,099652;1865;2021;156
1925;301;55,643464;9,651961;1889;2021;132
1925;308;55,671645;9,5777;1867;1939;72
1925;315;56,552152;9,40118;1868;2021;153
1925;322;54,9748134;12,2737822;1866;2021;155
1925;326;54,934174;9,248837;1905;1951;46
1925;328;54,873518;9,518945;1921;2021;100
1925;333;57,005237;9,774809;1915;1990;75
1925;336;56,032176;10,125522;1869;2005;136
1925;346;56,067076;10,134812;1866;2021;155
1925;13;55,18902;14,96054;1867;2021;154
1925;23;55,48022;8,43888;1910;2012;102
1925;28;56,3281;10,04992;1921;1936;15
1925;29;56,328077;10,04661;1876;2021;145
1925;115;55,88581;12,51109;1905;1958;53
1925;130;55,67057;11,18151;1899;2021;122
1925;191;55,1839;11,98427;1867;1947;80
1925;208;55,74166;11,41925;1865;2021;156
1925;235;56,14912;9,91448;1868;1939;71
1925;243;55,3931;11,36045;1909;1973;64
1925;252;55,2722;12,32416;1894;1953;59
1925;253;55,40862;12,1951;1900;1929;29
1925;304;55,72746;9,53248;1879;1942;63
1925;331;56,99987;9,99301;1899;1928;29
1926;6;55,269626;10,11524;1877;2009;132
1926;7;55,325496;10,197316;1906;1976;70
1926;19;57,141564;10,224039;1873;1974;101
1926;34;55,3214857;11,9687601;1891;1987;96
1926;35;55,3225039;11,9608428;1920;2010;90
1926;55;55,242371;10,53961;1866;2021;155
1926;66;54,790388;11,944494;1878;1937;59
1926;69;55,182844;9,45901;1920;2004;84
1926;73;55,84433;9,589121;1848;2021;173
1926;75;55,731027;9,833955;1866;1939;73
1926;77;56,028439;12,589834;1921;2021;100
1926;85;55,941434;12,268503;1895;1937;42
1926;88;55,944946;12,309925;1923;2021;98
1926;90;57,562284;9,986481;1891;1967;76
1926;93;57,356497;9,936222;1890;2021;131
1926;110;55,965642;9,717756;1884;2006;122
1926;126;57,16496;9,729678;1877;1951;74
1926;128;55,512352;11,287189;1866;1930;64
1926;140;55,585667;9,423096;1899;1961;62
1926;144;55,673798;12,577517;1891;2021;130
1926;145;55,682456;12,569828;1877;2021;144
1926;151;54,861238;10,73061;1867;1978;111
1926;155;56,557877;8,412895;1887;1976;89
1926;158;54,815811;11,264489;1905;1996;91
1926;160;55,78677;12,495101;1890;1937;47
1926;176;55,460727;9,822756;1880;1960;80
1926;177;56,839448;8,717907;1864;1946;82
1926;180;56,367177;10,746981;1897;1940;43
1926;181;56,483472;10,446191;1903;1932;29
1926;182;56,453059;10,866897;1868;1938;70
1926;188;55,513946;10,178703;1882;1938;56
1926;195;55,9775064;10,1756177;1890;2021;131
1926;205;55,790358;11,464283;1907;1972;65
1926;213;56,833601;10,113311;1885;1939;54
1926;215;56,886164;9,836899;1886;2009;123
1926;221;55,664541;12,092211;1907;1930;23
1926;236;56,090396;9,758625;1892;2021;129
1926;239;56,572888;9,051158;1907;2021;114
1926;251;55,4226556;11,5675895;1889;1927;38
1926;256;55,070962;10,511664;1920;2021;101
1926;257;55,074867;10,467835;1882;1953;71
1926;260;55,110103;10,734595;1867;1930;63
1926;270;56,302138;10,477471;1894;2021;127
1926;271;54,986632;9,977204;1920;2002;82
1926;294;55,471013;9,099652;1865;2021;156
1926;301;55,643464;9,651961;1889;2021;132
1926;308;55,671645;9,5777;1867;1939;72
1926;315;56,552152;9,40118;1868;2021;153
1926;322;54,9748134;12,2737822;1866;2021;155
1926;326;54,934174;9,248837;1905;1951;46
1926;328;54,873518;9,518945;1921;2021;100
1926;333;57,005237;9,774809;1915;1990;75
1926;336;56,032176;10,125522;1869;2005;136
1926;346;56,067076;10,134812;1866;2021;155
1926;13;55,18902;14,96054;1867;2021;154
1926;23;55,48022;8,43888;1910;2012;102
1926;28;56,3281;10,04992;1921;1936;15
1926;29;56,328077;10,04661;1876;2021;145
1926;115;55,88581;12,51109;1905;1958;53
1926;130;55,67057;11,18151;1899;2021;122
1926;191;55,1839;11,98427;1867;1947;80
1926;208;55,74166;11,41925;1865;2021;156
1926;235;56,14912;9,91448;1868;1939;71
1926;243;55,3931;11,36045;1909;1973;64
1926;252;55,2722;12,32416;1894;1953;59
1926;253;55,40862;12,1951;1900;1929;29
1926;304;55,72746;9,53248;1879;1942;63
1926;331;56,99987;9,99301;1899;1928;29
1927;6;55,269626;10,11524;1877;2009;132
1927;7;55,325496;10,197316;1906;1976;70
1927;19;57,141564;10,224039;1873;1974;101
1927;34;55,3214857;11,9687601;1891;1987;96
1927;35;55,3225039;11,9608428;1920;2010;90
1927;55;55,242371;10,53961;1866;2021;155
1927;66;54,790388;11,944494;1878;1937;59
1927;69;55,182844;9,45901;1920;2004;84
1927;73;55,84433;9,589121;1848;2021;173
1927;75;55,731027;9,833955;1866;1939;73
1927;77;56,028439;12,589834;1921;2021;100
1927;85;55,941434;12,268503;1895;1937;42
1927;88;55,944946;12,309925;1923;2021;98
1927;90;57,562284;9,986481;1891;1967;76
1927;93;57,356497;9,936222;1890;2021;131
1927;110;55,965642;9,717756;1884;2006;122
1927;126;57,16496;9,729678;1877;1951;74
1927;128;55,512352;11,287189;1866;1930;64
1927;140;55,585667;9,423096;1899;1961;62
1927;144;55,673798;12,577517;1891;2021;130
1927;145;55,682456;12,569828;1877;2021;144
1927;151;54,861238;10,73061;1867;1978;111
1927;155;56,557877;8,412895;1887;1976;89
1927;158;54,815811;11,264489;1905;1996;91
1927;160;55,78677;12,495101;1890;1937;47
1927;176;55,460727;9,822756;1880;1960;80
1927;177;56,839448;8,717907;1864;1946;82
1927;180;56,367177;10,746981;1897;1940;43
1927;181;56,483472;10,446191;1903;1932;29
1927;182;56,453059;10,866897;1868;1938;70
1927;188;55,513946;10,178703;1882;1938;56
1927;195;55,9775064;10,1756177;1890;2021;131
1927;205;55,790358;11,464283;1907;1972;65
1927;213;56,833601;10,113311;1885;1939;54
1927;215;56,886164;9,836899;1886;2009;123
1927;221;55,664541;12,092211;1907;1930;23
1927;236;56,090396;9,758625;1892;2021;129
1927;239;56,572888;9,051158;1907;2021;114
1927;251;55,4226556;11,5675895;1889;1927;38
1927;256;55,070962;10,511664;1920;2021;101
1927;257;55,074867;10,467835;1882;1953;71
1927;260;55,110103;10,734595;1867;1930;63
1927;270;56,302138;10,477471;1894;2021;127
1927;271;54,986632;9,977204;1920;2002;82
1927;294;55,471013;9,099652;1865;2021;156
1927;301;55,643464;9,651961;1889;2021;132
1927;308;55,671645;9,5777;1867;1939;72
1927;315;56,552152;9,40118;1868;2021;153
1927;322;54,9748134;12,2737822;1866;2021;155
1927;326;54,934174;9,248837;1905;1951;46
1927;328;54,873518;9,518945;1921;2021;100
1927;333;57,005237;9,774809;1915;1990;75
1927;336;56,032176;10,125522;1869;2005;136
1927;346;56,067076;10,134812;1866;2021;155
1927;13;55,18902;14,96054;1867;2021;154
1927;23;55,48022;8,43888;1910;2012;102
1927;28;56,3281;10,04992;1921;1936;15
1927;29;56,328077;10,04661;1876;2021;145
1927;115;55,88581;12,51109;1905;1958;53
1927;130;55,67057;11,18151;1899;2021;122
1927;191;55,1839;11,98427;1867;1947;80
1927;208;55,74166;11,41925;1865;2021;156
1927;235;56,14912;9,91448;1868;1939;71
1927;243;55,3931;11,36045;1909;1973;64
1927;252;55,2722;12,32416;1894;1953;59
1927;253;55,40862;12,1951;1900;1929;29
1927;304;55,72746;9,53248;1879;1942;63
1927;331;56,99987;9,99301;1899;1928;29
1928;6;55,269626;10,11524;1877;2009;132
1928;7;55,325496;10,197316;1906;1976;70
1928;19;57,141564;10,224039;1873;1974;101
1928;34;55,3214857;11,9687601;1891;1987;96
1928;35;55,3225039;11,9608428;1920;2010;90
1928;55;55,242371;10,53961;1866;2021;155
1928;66;54,790388;11,944494;1878;1937;59
1928;69;55,182844;9,45901;1920;2004;84
1928;73;55,84433;9,589121;1848;2021;173
1928;75;55,731027;9,833955;1866;1939;73
1928;77;56,028439;12,589834;1921;2021;100
1928;85;55,941434;12,268503;1895;1937;42
1928;88;55,944946;12,309925;1923;2021;98
1928;90;57,562284;9,986481;1891;1967;76
1928;93;57,356497;9,936222;1890;2021;131
1928;98;55,613092;11,778498;1928;1952;24
1928;110;55,965642;9,717756;1884;2006;122
1928;126;57,16496;9,729678;1877;1951;74
1928;128;55,512352;11,287189;1866;1930;64
1928;140;55,585667;9,423096;1899;1961;62
1928;144;55,673798;12,577517;1891;2021;130
1928;145;55,682456;12,569828;1877;2021;144
1928;151;54,861238;10,73061;1867;1978;111
1928;155;56,557877;8,412895;1887;1976;89
1928;158;54,815811;11,264489;1905;1996;91
1928;160;55,78677;12,495101;1890;1937;47
1928;176;55,460727;9,822756;1880;1960;80
1928;177;56,839448;8,717907;1864;1946;82
1928;180;56,367177;10,746981;1897;1940;43
1928;181;56,483472;10,446191;1903;1932;29
1928;182;56,453059;10,866897;1868;1938;70
1928;188;55,513946;10,178703;1882;1938;56
1928;195;55,9775064;10,1756177;1890;2021;131
1928;205;55,790358;11,464283;1907;1972;65
1928;213;56,833601;10,113311;1885;1939;54
1928;215;56,886164;9,836899;1886;2009;123
1928;221;55,664541;12,092211;1907;1930;23
1928;236;56,090396;9,758625;1892;2021;129
1928;239;56,572888;9,051158;1907;2021;114
1928;256;55,070962;10,511664;1920;2021;101
1928;257;55,074867;10,467835;1882;1953;71
1928;260;55,110103;10,734595;1867;1930;63
1928;270;56,302138;10,477471;1894;2021;127
1928;271;54,986632;9,977204;1920;2002;82
1928;294;55,471013;9,099652;1865;2021;156
1928;301;55,643464;9,651961;1889;2021;132
1928;308;55,671645;9,5777;1867;1939;72
1928;315;56,552152;9,40118;1868;2021;153
1928;322;54,9748134;12,2737822;1866;2021;155
1928;326;54,934174;9,248837;1905;1951;46
1928;328;54,873518;9,518945;1921;2021;100
1928;333;57,005237;9,774809;1915;1990;75
1928;336;56,032176;10,125522;1869;2005;136
1928;346;56,067076;10,134812;1866;2021;155
1928;13;55,18902;14,96054;1867;2021;154
1928;23;55,48022;8,43888;1910;2012;102
1928;28;56,3281;10,04992;1921;1936;15
1928;29;56,328077;10,04661;1876;2021;145
1928;115;55,88581;12,51109;1905;1958;53
1928;130;55,67057;11,18151;1899;2021;122
1928;191;55,1839;11,98427;1867;1947;80
1928;208;55,74166;11,41925;1865;2021;156
1928;235;56,14912;9,91448;1868;1939;71
1928;243;55,3931;11,36045;1909;1973;64
1928;252;55,2722;12,32416;1894;1953;59
1928;253;55,40862;12,1951;1900;1929;29
1928;304;55,72746;9,53248;1879;1942;63
1928;331;56,99987;9,99301;1899;1928;29
1928;337;56,13962;10,20498;1928;2004;76
1929;6;55,269626;10,11524;1877;2009;132
1929;7;55,325496;10,197316;1906;1976;70
1929;19;57,141564;10,224039;1873;1974;101
1929;34;55,3214857;11,9687601;1891;1987;96
1929;35;55,3225039;11,9608428;1920;2010;90
1929;55;55,242371;10,53961;1866;2021;155
1929;66;54,790388;11,944494;1878;1937;59
1929;69;55,182844;9,45901;1920;2004;84
1929;73;55,84433;9,589121;1848;2021;173
1929;75;55,731027;9,833955;1866;1939;73
1929;77;56,028439;12,589834;1921;2021;100
1929;85;55,941434;12,268503;1895;1937;42
1929;88;55,944946;12,309925;1923;2021;98
1929;90;57,562284;9,986481;1891;1967;76
1929;93;57,356497;9,936222;1890;2021;131
1929;98;55,613092;11,778498;1928;1952;24
1929;110;55,965642;9,717756;1884;2006;122
1929;126;57,16496;9,729678;1877;1951;74
1929;128;55,512352;11,287189;1866;1930;64
1929;140;55,585667;9,423096;1899;1961;62
1929;144;55,673798;12,577517;1891;2021;130
1929;145;55,682456;12,569828;1877;2021;144
1929;151;54,861238;10,73061;1867;1978;111
1929;155;56,557877;8,412895;1887;1976;89
1929;158;54,815811;11,264489;1905;1996;91
1929;160;55,78677;12,495101;1890;1937;47
1929;176;55,460727;9,822756;1880;1960;80
1929;177;56,839448;8,717907;1864;1946;82
1929;180;56,367177;10,746981;1897;1940;43
1929;181;56,483472;10,446191;1903;1932;29
1929;182;56,453059;10,866897;1868;1938;70
1929;188;55,513946;10,178703;1882;1938;56
1929;195;55,9775064;10,1756177;1890;2021;131
1929;205;55,790358;11,464283;1907;1972;65
1929;213;56,833601;10,113311;1885;1939;54
1929;215;56,886164;9,836899;1886;2009;123
1929;221;55,664541;12,092211;1907;1930;23
1929;236;56,090396;9,758625;1892;2021;129
1929;239;56,572888;9,051158;1907;2021;114
1929;256;55,070962;10,511664;1920;2021;101
1929;257;55,074867;10,467835;1882;1953;71
1929;260;55,110103;10,734595;1867;1930;63
1929;270;56,302138;10,477471;1894;2021;127
1929;271;54,986632;9,977204;1920;2002;82
1929;294;55,471013;9,099652;1865;2021;156
1929;301;55,643464;9,651961;1889;2021;132
1929;308;55,671645;9,5777;1867;1939;72
1929;315;56,552152;9,40118;1868;2021;153
1929;322;54,9748134;12,2737822;1866;2021;155
1929;326;54,934174;9,248837;1905;1951;46
1929;328;54,873518;9,518945;1921;2021;100
1929;333;57,005237;9,774809;1915;1990;75
1929;336;56,032176;10,125522;1869;2005;136
1929;346;56,067076;10,134812;1866;2021;155
1929;13;55,18902;14,96054;1867;2021;154
1929;23;55,48022;8,43888;1910;2012;102
1929;28;56,3281;10,04992;1921;1936;15
1929;29;56,328077;10,04661;1876;2021;145
1929;115;55,88581;12,51109;1905;1958;53
1929;130;55,67057;11,18151;1899;2021;122
1929;191;55,1839;11,98427;1867;1947;80
1929;208;55,74166;11,41925;1865;2021;156
1929;235;56,14912;9,91448;1868;1939;71
1929;243;55,3931;11,36045;1909;1973;64
1929;252;55,2722;12,32416;1894;1953;59
1929;253;55,40862;12,1951;1900;1929;29
1929;304;55,72746;9,53248;1879;1942;63
1929;337;56,13962;10,20498;1928;2004;76
1930;6;55,269626;10,11524;1877;2009;132
1930;7;55,325496;10,197316;1906;1976;70
1930;19;57,141564;10,224039;1873;1974;101
1930;34;55,3214857;11,9687601;1891;1987;96
1930;35;55,3225039;11,9608428;1920;2010;90
1930;55;55,242371;10,53961;1866;2021;155
1930;66;54,790388;11,944494;1878;1937;59
1930;69;55,182844;9,45901;1920;2004;84
1930;73;55,84433;9,589121;1848;2021;173
1930;74;55,714019;9,683858;1930;1972;42
1930;75;55,731027;9,833955;1866;1939;73
1930;77;56,028439;12,589834;1921;2021;100
1930;85;55,941434;12,268503;1895;1937;42
1930;88;55,944946;12,309925;1923;2021;98
1930;90;57,562284;9,986481;1891;1967;76
1930;93;57,356497;9,936222;1890;2021;131
1930;98;55,613092;11,778498;1928;1952;24
1930;110;55,965642;9,717756;1884;2006;122
1930;126;57,16496;9,729678;1877;1951;74
1930;128;55,512352;11,287189;1866;1930;64
1930;140;55,585667;9,423096;1899;1961;62
1930;144;55,673798;12,577517;1891;2021;130
1930;145;55,682456;12,569828;1877;2021;144
1930;151;54,861238;10,73061;1867;1978;111
1930;155;56,557877;8,412895;1887;1976;89
1930;158;54,815811;11,264489;1905;1996;91
1930;160;55,78677;12,495101;1890;1937;47
1930;176;55,460727;9,822756;1880;1960;80
1930;177;56,839448;8,717907;1864;1946;82
1930;180;56,367177;10,746981;1897;1940;43
1930;181;56,483472;10,446191;1903;1932;29
1930;182;56,453059;10,866897;1868;1938;70
1930;188;55,513946;10,178703;1882;1938;56
1930;195;55,9775064;10,1756177;1890;2021;131
1930;205;55,790358;11,464283;1907;1972;65
1930;213;56,833601;10,113311;1885;1939;54
1930;215;56,886164;9,836899;1886;2009;123
1930;221;55,664541;12,092211;1907;1930;23
1930;236;56,090396;9,758625;1892;2021;129
1930;239;56,572888;9,051158;1907;2021;114
1930;256;55,070962;10,511664;1920;2021;101
1930;257;55,074867;10,467835;1882;1953;71
1930;260;55,110103;10,734595;1867;1930;63
1930;270;56,302138;10,477471;1894;2021;127
1930;271;54,986632;9,977204;1920;2002;82
1930;294;55,471013;9,099652;1865;2021;156
1930;301;55,643464;9,651961;1889;2021;132
1930;308;55,671645;9,5777;1867;1939;72
1930;315;56,552152;9,40118;1868;2021;153
1930;322;54,9748134;12,2737822;1866;2021;155
1930;326;54,934174;9,248837;1905;1951;46
1930;328;54,873518;9,518945;1921;2021;100
1930;333;57,005237;9,774809;1915;1990;75
1930;336;56,032176;10,125522;1869;2005;136
1930;346;56,067076;10,134812;1866;2021;155
1930;13;55,18902;14,96054;1867;2021;154
1930;23;55,48022;8,43888;1910;2012;102
1930;28;56,3281;10,04992;1921;1936;15
1930;29;56,328077;10,04661;1876;2021;145
1930;115;55,88581;12,51109;1905;1958;53
1930;130;55,67057;11,18151;1899;2021;122
1930;191;55,1839;11,98427;1867;1947;80
1930;208;55,74166;11,41925;1865;2021;156
1930;219;55,66464;12,09277;1930;2001;71
1930;235;56,14912;9,91448;1868;1939;71
1930;243;55,3931;11,36045;1909;1973;64
1930;252;55,2722;12,32416;1894;1953;59
1930;304;55,72746;9,53248;1879;1942;63
1930;337;56,13962;10,20498;1928;2004;76
1931;6;55,269626;10,11524;1877;2009;132
1931;7;55,325496;10,197316;1906;1976;70
1931;19;57,141564;10,224039;1873;1974;101
1931;34;55,3214857;11,9687601;1891;1987;96
1931;35;55,3225039;11,9608428;1920;2010;90
1931;55;55,242371;10,53961;1866;2021;155
1931;66;54,790388;11,944494;1878;1937;59
1931;69;55,182844;9,45901;1920;2004;84
1931;73;55,84433;9,589121;1848;2021;173
1931;74;55,714019;9,683858;1930;1972;42
1931;75;55,731027;9,833955;1866;1939;73
1931;77;56,028439;12,589834;1921;2021;100
1931;85;55,941434;12,268503;1895;1937;42
1931;88;55,944946;12,309925;1923;2021;98
1931;90;57,562284;9,986481;1891;1967;76
1931;93;57,356497;9,936222;1890;2021;131
1931;98;55,613092;11,778498;1928;1952;24
1931;110;55,965642;9,717756;1884;2006;122
1931;126;57,16496;9,729678;1877;1951;74
1931;140;55,585667;9,423096;1899;1961;62
1931;144;55,673798;12,577517;1891;2021;130
1931;145;55,682456;12,569828;1877;2021;144
1931;151;54,861238;10,73061;1867;1978;111
1931;155;56,557877;8,412895;1887;1976;89
1931;158;54,815811;11,264489;1905;1996;91
1931;160;55,78677;12,495101;1890;1937;47
1931;176;55,460727;9,822756;1880;1960;80
1931;177;56,839448;8,717907;1864;1946;82
1931;180;56,367177;10,746981;1897;1940;43
1931;181;56,483472;10,446191;1903;1932;29
1931;182;56,453059;10,866897;1868;1938;70
1931;188;55,513946;10,178703;1882;1938;56
1931;195;55,9775064;10,1756177;1890;2021;131
1931;205;55,790358;11,464283;1907;1972;65
1931;213;56,833601;10,113311;1885;1939;54
1931;215;56,886164;9,836899;1886;2009;123
1931;236;56,090396;9,758625;1892;2021;129
1931;239;56,572888;9,051158;1907;2021;114
1931;256;55,070962;10,511664;1920;2021;101
1931;257;55,074867;10,467835;1882;1953;71
1931;270;56,302138;10,477471;1894;2021;127
1931;271;54,986632;9,977204;1920;2002;82
1931;294;55,471013;9,099652;1865;2021;156
1931;301;55,643464;9,651961;1889;2021;132
1931;308;55,671645;9,5777;1867;1939;72
1931;315;56,552152;9,40118;1868;2021;153
1931;322;54,9748134;12,2737822;1866;2021;155
1931;326;54,934174;9,248837;1905;1951;46
1931;328;54,873518;9,518945;1921;2021;100
1931;333;57,005237;9,774809;1915;1990;75
1931;336;56,032176;10,125522;1869;2005;136
1931;346;56,067076;10,134812;1866;2021;155
1931;13;55,18902;14,96054;1867;2021;154
1931;23;55,48022;8,43888;1910;2012;102
1931;28;56,3281;10,04992;1921;1936;15
1931;29;56,328077;10,04661;1876;2021;145
1931;115;55,88581;12,51109;1905;1958;53
1931;130;55,67057;11,18151;1899;2021;122
1931;191;55,1839;11,98427;1867;1947;80
1931;208;55,74166;11,41925;1865;2021;156
1931;219;55,66464;12,09277;1930;2001;71
1931;235;56,14912;9,91448;1868;1939;71
1931;243;55,3931;11,36045;1909;1973;64
1931;252;55,2722;12,32416;1894;1953;59
1931;304;55,72746;9,53248;1879;1942;63
1931;337;56,13962;10,20498;1928;2004;76
1932;6;55,269626;10,11524;1877;2009;132
1932;7;55,325496;10,197316;1906;1976;70
1932;19;57,141564;10,224039;1873;1974;101
1932;34;55,3214857;11,9687601;1891;1987;96
1932;35;55,3225039;11,9608428;1920;2010;90
1932;55;55,242371;10,53961;1866;2021;155
1932;66;54,790388;11,944494;1878;1937;59
1932;69;55,182844;9,45901;1920;2004;84
1932;73;55,84433;9,589121;1848;2021;173
1932;74;55,714019;9,683858;1930;1972;42
1932;75;55,731027;9,833955;1866;1939;73
1932;77;56,028439;12,589834;1921;2021;100
1932;85;55,941434;12,268503;1895;1937;42
1932;88;55,944946;12,309925;1923;2021;98
1932;90;57,562284;9,986481;1891;1967;76
1932;93;57,356497;9,936222;1890;2021;131
1932;98;55,613092;11,778498;1928;1952;24
1932;110;55,965642;9,717756;1884;2006;122
1932;126;57,16496;9,729678;1877;1951;74
1932;140;55,585667;9,423096;1899;1961;62
1932;144;55,673798;12,577517;1891;2021;130
1932;145;55,682456;12,569828;1877;2021;144
1932;151;54,861238;10,73061;1867;1978;111
1932;155;56,557877;8,412895;1887;1976;89
1932;158;54,815811;11,264489;1905;1996;91
1932;160;55,78677;12,495101;1890;1937;47
1932;168;55,51314;9,764369;1932;1978;46
1932;176;55,460727;9,822756;1880;1960;80
1932;177;56,839448;8,717907;1864;1946;82
1932;180;56,367177;10,746981;1897;1940;43
1932;181;56,483472;10,446191;1903;1932;29
1932;182;56,453059;10,866897;1868;1938;70
1932;188;55,513946;10,178703;1882;1938;56
1932;195;55,9775064;10,1756177;1890;2021;131
1932;205;55,790358;11,464283;1907;1972;65
1932;213;56,833601;10,113311;1885;1939;54
1932;215;56,886164;9,836899;1886;2009;123
1932;236;56,090396;9,758625;1892;2021;129
1932;239;56,572888;9,051158;1907;2021;114
1932;256;55,070962;10,511664;1920;2021;101
1932;257;55,074867;10,467835;1882;1953;71
1932;270;56,302138;10,477471;1894;2021;127
1932;271;54,986632;9,977204;1920;2002;82
1932;294;55,471013;9,099652;1865;2021;156
1932;301;55,643464;9,651961;1889;2021;132
1932;308;55,671645;9,5777;1867;1939;72
1932;315;56,552152;9,40118;1868;2021;153
1932;322;54,9748134;12,2737822;1866;2021;155
1932;326;54,934174;9,248837;1905;1951;46
1932;328;54,873518;9,518945;1921;2021;100
1932;333;57,005237;9,774809;1915;1990;75
1932;336;56,032176;10,125522;1869;2005;136
1932;346;56,067076;10,134812;1866;2021;155
1932;13;55,18902;14,96054;1867;2021;154
1932;23;55,48022;8,43888;1910;2012;102
1932;28;56,3281;10,04992;1921;1936;15
1932;29;56,328077;10,04661;1876;2021;145
1932;115;55,88581;12,51109;1905;1958;53
1932;130;55,67057;11,18151;1899;2021;122
1932;191;55,1839;11,98427;1867;1947;80
1932;208;55,74166;11,41925;1865;2021;156
1932;219;55,66464;12,09277;1930;2001;71
1932;235;56,14912;9,91448;1868;1939;71
1932;243;55,3931;11,36045;1909;1973;64
1932;252;55,2722;12,32416;1894;1953;59
1932;304;55,72746;9,53248;1879;1942;63
1932;337;56,13962;10,20498;1928;2004;76
1933;6;55,269626;10,11524;1877;2009;132
1933;7;55,325496;10,197316;1906;1976;70
1933;19;57,141564;10,224039;1873;1974;101
1933;34;55,3214857;11,9687601;1891;1987;96
1933;35;55,3225039;11,9608428;1920;2010;90
1933;55;55,242371;10,53961;1866;2021;155
1933;66;54,790388;11,944494;1878;1937;59
1933;69;55,182844;9,45901;1920;2004;84
1933;73;55,84433;9,589121;1848;2021;173
1933;74;55,714019;9,683858;1930;1972;42
1933;75;55,731027;9,833955;1866;1939;73
1933;77;56,028439;12,589834;1921;2021;100
1933;85;55,941434;12,268503;1895;1937;42
1933;88;55,944946;12,309925;1923;2021;98
1933;90;57,562284;9,986481;1891;1967;76
1933;93;57,356497;9,936222;1890;2021;131
1933;98;55,613092;11,778498;1928;1952;24
1933;110;55,965642;9,717756;1884;2006;122
1933;126;57,16496;9,729678;1877;1951;74
1933;140;55,585667;9,423096;1899;1961;62
1933;144;55,673798;12,577517;1891;2021;130
1933;145;55,682456;12,569828;1877;2021;144
1933;151;54,861238;10,73061;1867;1978;111
1933;155;56,557877;8,412895;1887;1976;89
1933;158;54,815811;11,264489;1905;1996;91
1933;160;55,78677;12,495101;1890;1937;47
1933;168;55,51314;9,764369;1932;1978;46
1933;176;55,460727;9,822756;1880;1960;80
1933;177;56,839448;8,717907;1864;1946;82
1933;180;56,367177;10,746981;1897;1940;43
1933;182;56,453059;10,866897;1868;1938;70
1933;188;55,513946;10,178703;1882;1938;56
1933;195;55,9775064;10,1756177;1890;2021;131
1933;205;55,790358;11,464283;1907;1972;65
1933;213;56,833601;10,113311;1885;1939;54
1933;215;56,886164;9,836899;1886;2009;123
1933;236;56,090396;9,758625;1892;2021;129
1933;239;56,572888;9,051158;1907;2021;114
1933;256;55,070962;10,511664;1920;2021;101
1933;257;55,074867;10,467835;1882;1953;71
1933;270;56,302138;10,477471;1894;2021;127
1933;271;54,986632;9,977204;1920;2002;82
1933;294;55,471013;9,099652;1865;2021;156
1933;301;55,643464;9,651961;1889;2021;132
1933;308;55,671645;9,5777;1867;1939;72
1933;315;56,552152;9,40118;1868;2021;153
1933;322;54,9748134;12,2737822;1866;2021;155
1933;326;54,934174;9,248837;1905;1951;46
1933;328;54,873518;9,518945;1921;2021;100
1933;333;57,005237;9,774809;1915;1990;75
1933;336;56,032176;10,125522;1869;2005;136
1933;346;56,067076;10,134812;1866;2021;155
1933;13;55,18902;14,96054;1867;2021;154
1933;23;55,48022;8,43888;1910;2012;102
1933;28;56,3281;10,04992;1921;1936;15
1933;29;56,328077;10,04661;1876;2021;145
1933;115;55,88581;12,51109;1905;1958;53
1933;130;55,67057;11,18151;1899;2021;122
1933;191;55,1839;11,98427;1867;1947;80
1933;208;55,74166;11,41925;1865;2021;156
1933;219;55,66464;12,09277;1930;2001;71
1933;235;56,14912;9,91448;1868;1939;71
1933;243;55,3931;11,36045;1909;1973;64
1933;252;55,2722;12,32416;1894;1953;59
1933;304;55,72746;9,53248;1879;1942;63
1933;337;56,13962;10,20498;1928;2004;76
1934;6;55,269626;10,11524;1877;2009;132
1934;7;55,325496;10,197316;1906;1976;70
1934;19;57,141564;10,224039;1873;1974;101
1934;34;55,3214857;11,9687601;1891;1987;96
1934;35;55,3225039;11,9608428;1920;2010;90
1934;55;55,242371;10,53961;1866;2021;155
1934;66;54,790388;11,944494;1878;1937;59
1934;69;55,182844;9,45901;1920;2004;84
1934;73;55,84433;9,589121;1848;2021;173
1934;74;55,714019;9,683858;1930;1972;42
1934;75;55,731027;9,833955;1866;1939;73
1934;77;56,028439;12,589834;1921;2021;100
1934;85;55,941434;12,268503;1895;1937;42
1934;88;55,944946;12,309925;1923;2021;98
1934;90;57,562284;9,986481;1891;1967;76
1934;93;57,356497;9,936222;1890;2021;131
1934;98;55,613092;11,778498;1928;1952;24
1934;110;55,965642;9,717756;1884;2006;122
1934;126;57,16496;9,729678;1877;1951;74
1934;140;55,585667;9,423096;1899;1961;62
1934;144;55,673798;12,577517;1891;2021;130
1934;145;55,682456;12,569828;1877;2021;144
1934;151;54,861238;10,73061;1867;1978;111
1934;155;56,557877;8,412895;1887;1976;89
1934;158;54,815811;11,264489;1905;1996;91
1934;160;55,78677;12,495101;1890;1937;47
1934;168;55,51314;9,764369;1932;1978;46
1934;176;55,460727;9,822756;1880;1960;80
1934;177;56,839448;8,717907;1864;1946;82
1934;180;56,367177;10,746981;1897;1940;43
1934;182;56,453059;10,866897;1868;1938;70
1934;188;55,513946;10,178703;1882;1938;56
1934;195;55,9775064;10,1756177;1890;2021;131
1934;205;55,790358;11,464283;1907;1972;65
1934;213;56,833601;10,113311;1885;1939;54
1934;215;56,886164;9,836899;1886;2009;123
1934;236;56,090396;9,758625;1892;2021;129
1934;239;56,572888;9,051158;1907;2021;114
1934;256;55,070962;10,511664;1920;2021;101
1934;257;55,074867;10,467835;1882;1953;71
1934;270;56,302138;10,477471;1894;2021;127
1934;271;54,986632;9,977204;1920;2002;82
1934;294;55,471013;9,099652;1865;2021;156
1934;301;55,643464;9,651961;1889;2021;132
1934;308;55,671645;9,5777;1867;1939;72
1934;315;56,552152;9,40118;1868;2021;153
1934;322;54,9748134;12,2737822;1866;2021;155
1934;326;54,934174;9,248837;1905;1951;46
1934;328;54,873518;9,518945;1921;2021;100
1934;333;57,005237;9,774809;1915;1990;75
1934;336;56,032176;10,125522;1869;2005;136
1934;346;56,067076;10,134812;1866;2021;155
1934;13;55,18902;14,96054;1867;2021;154
1934;23;55,48022;8,43888;1910;2012;102
1934;28;56,3281;10,04992;1921;1936;15
1934;29;56,328077;10,04661;1876;2021;145
1934;115;55,88581;12,51109;1905;1958;53
1934;130;55,67057;11,18151;1899;2021;122
1934;190;55,28738;11,55875;1934;1940;6
1934;191;55,1839;11,98427;1867;1947;80
1934;208;55,74166;11,41925;1865;2021;156
1934;219;55,66464;12,09277;1930;2001;71
1934;235;56,14912;9,91448;1868;1939;71
1934;243;55,3931;11,36045;1909;1973;64
1934;252;55,2722;12,32416;1894;1953;59
1934;304;55,72746;9,53248;1879;1942;63
1934;337;56,13962;10,20498;1928;2004;76
1935;6;55,269626;10,11524;1877;2009;132
1935;7;55,325496;10,197316;1906;1976;70
1935;19;57,141564;10,224039;1873;1974;101
1935;34;55,3214857;11,9687601;1891;1987;96
1935;35;55,3225039;11,9608428;1920;2010;90
1935;55;55,242371;10,53961;1866;2021;155
1935;66;54,790388;11,944494;1878;1937;59
1935;69;55,182844;9,45901;1920;2004;84
1935;73;55,84433;9,589121;1848;2021;173
1935;74;55,714019;9,683858;1930;1972;42
1935;75;55,731027;9,833955;1866;1939;73
1935;77;56,028439;12,589834;1921;2021;100
1935;85;55,941434;12,268503;1895;1937;42
1935;88;55,944946;12,309925;1923;2021;98
1935;90;57,562284;9,986481;1891;1967;76
1935;93;57,356497;9,936222;1890;2021;131
1935;98;55,613092;11,778498;1928;1952;24
1935;110;55,965642;9,717756;1884;2006;122
1935;126;57,16496;9,729678;1877;1951;74
1935;140;55,585667;9,423096;1899;1961;62
1935;144;55,673798;12,577517;1891;2021;130
1935;145;55,682456;12,569828;1877;2021;144
1935;151;54,861238;10,73061;1867;1978;111
1935;155;56,557877;8,412895;1887;1976;89
1935;158;54,815811;11,264489;1905;1996;91
1935;160;55,78677;12,495101;1890;1937;47
1935;168;55,51314;9,764369;1932;1978;46
1935;176;55,460727;9,822756;1880;1960;80
1935;177;56,839448;8,717907;1864;1946;82
1935;180;56,367177;10,746981;1897;1940;43
1935;182;56,453059;10,866897;1868;1938;70
1935;188;55,513946;10,178703;1882;1938;56
1935;195;55,9775064;10,1756177;1890;2021;131
1935;205;55,790358;11,464283;1907;1972;65
1935;213;56,833601;10,113311;1885;1939;54
1935;215;56,886164;9,836899;1886;2009;123
1935;236;56,090396;9,758625;1892;2021;129
1935;239;56,572888;9,051158;1907;2021;114
1935;256;55,070962;10,511664;1920;2021;101
1935;257;55,074867;10,467835;1882;1953;71
1935;270;56,302138;10,477471;1894;2021;127
1935;271;54,986632;9,977204;1920;2002;82
1935;294;55,471013;9,099652;1865;2021;156
1935;301;55,643464;9,651961;1889;2021;132
1935;308;55,671645;9,5777;1867;1939;72
1935;315;56,552152;9,40118;1868;2021;153
1935;322;54,9748134;12,2737822;1866;2021;155
1935;326;54,934174;9,248837;1905;1951;46
1935;328;54,873518;9,518945;1921;2021;100
1935;333;57,005237;9,774809;1915;1990;75
1935;336;56,032176;10,125522;1869;2005;136
1935;346;56,067076;10,134812;1866;2021;155
1935;13;55,18902;14,96054;1867;2021;154
1935;23;55,48022;8,43888;1910;2012;102
1935;28;56,3281;10,04992;1921;1936;15
1935;29;56,328077;10,04661;1876;2021;145
1935;115;55,88581;12,51109;1905;1958;53
1935;130;55,67057;11,18151;1899;2021;122
1935;190;55,28738;11,55875;1934;1940;6
1935;191;55,1839;11,98427;1867;1947;80
1935;208;55,74166;11,41925;1865;2021;156
1935;219;55,66464;12,09277;1930;2001;71
1935;235;56,14912;9,91448;1868;1939;71
1935;243;55,3931;11,36045;1909;1973;64
1935;252;55,2722;12,32416;1894;1953;59
1935;304;55,72746;9,53248;1879;1942;63
1935;337;56,13962;10,20498;1928;2004;76
1936;6;55,269626;10,11524;1877;2009;132
1936;7;55,325496;10,197316;1906;1976;70
1936;19;57,141564;10,224039;1873;1974;101
1936;34;55,3214857;11,9687601;1891;1987;96
1936;35;55,3225039;11,9608428;1920;2010;90
1936;55;55,242371;10,53961;1866;2021;155
1936;66;54,790388;11,944494;1878;1937;59
1936;69;55,182844;9,45901;1920;2004;84
1936;73;55,84433;9,589121;1848;2021;173
1936;74;55,714019;9,683858;1930;1972;42
1936;75;55,731027;9,833955;1866;1939;73
1936;77;56,028439;12,589834;1921;2021;100
1936;85;55,941434;12,268503;1895;1937;42
1936;88;55,944946;12,309925;1923;2021;98
1936;90;57,562284;9,986481;1891;1967;76
1936;93;57,356497;9,936222;1890;2021;131
1936;98;55,613092;11,778498;1928;1952;24
1936;110;55,965642;9,717756;1884;2006;122
1936;126;57,16496;9,729678;1877;1951;74
1936;140;55,585667;9,423096;1899;1961;62
1936;144;55,673798;12,577517;1891;2021;130
1936;145;55,682456;12,569828;1877;2021;144
1936;151;54,861238;10,73061;1867;1978;111
1936;155;56,557877;8,412895;1887;1976;89
1936;158;54,815811;11,264489;1905;1996;91
1936;160;55,78677;12,495101;1890;1937;47
1936;168;55,51314;9,764369;1932;1978;46
1936;176;55,460727;9,822756;1880;1960;80
1936;177;56,839448;8,717907;1864;1946;82
1936;180;56,367177;10,746981;1897;1940;43
1936;182;56,453059;10,866897;1868;1938;70
1936;188;55,513946;10,178703;1882;1938;56
1936;195;55,9775064;10,1756177;1890;2021;131
1936;205;55,790358;11,464283;1907;1972;65
1936;213;56,833601;10,113311;1885;1939;54
1936;215;56,886164;9,836899;1886;2009;123
1936;236;56,090396;9,758625;1892;2021;129
1936;239;56,572888;9,051158;1907;2021;114
1936;256;55,070962;10,511664;1920;2021;101
1936;257;55,074867;10,467835;1882;1953;71
1936;270;56,302138;10,477471;1894;2021;127
1936;271;54,986632;9,977204;1920;2002;82
1936;294;55,471013;9,099652;1865;2021;156
1936;301;55,643464;9,651961;1889;2021;132
1936;308;55,671645;9,5777;1867;1939;72
1936;315;56,552152;9,40118;1868;2021;153
1936;322;54,9748134;12,2737822;1866;2021;155
1936;326;54,934174;9,248837;1905;1951;46
1936;328;54,873518;9,518945;1921;2021;100
1936;333;57,005237;9,774809;1915;1990;75
1936;336;56,032176;10,125522;1869;2005;136
1936;346;56,067076;10,134812;1866;2021;155
1936;13;55,18902;14,96054;1867;2021;154
1936;23;55,48022;8,43888;1910;2012;102
1936;28;56,3281;10,04992;1921;1936;15
1936;29;56,328077;10,04661;1876;2021;145
1936;115;55,88581;12,51109;1905;1958;53
1936;130;55,67057;11,18151;1899;2021;122
1936;190;55,28738;11,55875;1934;1940;6
1936;191;55,1839;11,98427;1867;1947;80
1936;208;55,74166;11,41925;1865;2021;156
1936;219;55,66464;12,09277;1930;2001;71
1936;235;56,14912;9,91448;1868;1939;71
1936;243;55,3931;11,36045;1909;1973;64
1936;252;55,2722;12,32416;1894;1953;59
1936;304;55,72746;9,53248;1879;1942;63
1936;337;56,13962;10,20498;1928;2004;76
1937;6;55,269626;10,11524;1877;2009;132
1937;7;55,325496;10,197316;1906;1976;70
1937;19;57,141564;10,224039;1873;1974;101
1937;34;55,3214857;11,9687601;1891;1987;96
1937;35;55,3225039;11,9608428;1920;2010;90
1937;55;55,242371;10,53961;1866;2021;155
1937;66;54,790388;11,944494;1878;1937;59
1937;69;55,182844;9,45901;1920;2004;84
1937;73;55,84433;9,589121;1848;2021;173
1937;74;55,714019;9,683858;1930;1972;42
1937;75;55,731027;9,833955;1866;1939;73
1937;77;56,028439;12,589834;1921;2021;100
1937;85;55,941434;12,268503;1895;1937;42
1937;87;55,941434;12,268503;1937;2021;84
1937;88;55,944946;12,309925;1923;2021;98
1937;90;57,562284;9,986481;1891;1967;76
1937;93;57,356497;9,936222;1890;2021;131
1937;98;55,613092;11,778498;1928;1952;24
1937;110;55,965642;9,717756;1884;2006;122
1937;126;57,16496;9,729678;1877;1951;74
1937;140;55,585667;9,423096;1899;1961;62
1937;144;55,673798;12,577517;1891;2021;130
1937;145;55,682456;12,569828;1877;2021;144
1937;151;54,861238;10,73061;1867;1978;111
1937;155;56,557877;8,412895;1887;1976;89
1937;158;54,815811;11,264489;1905;1996;91
1937;160;55,78677;12,495101;1890;1937;47
1937;168;55,51314;9,764369;1932;1978;46
1937;176;55,460727;9,822756;1880;1960;80
1937;177;56,839448;8,717907;1864;1946;82
1937;180;56,367177;10,746981;1897;1940;43
1937;182;56,453059;10,866897;1868;1938;70
1937;188;55,513946;10,178703;1882;1938;56
1937;195;55,9775064;10,1756177;1890;2021;131
1937;205;55,790358;11,464283;1907;1972;65
1937;213;56,833601;10,113311;1885;1939;54
1937;215;56,886164;9,836899;1886;2009;123
1937;236;56,090396;9,758625;1892;2021;129
1937;239;56,572888;9,051158;1907;2021;114
1937;256;55,070962;10,511664;1920;2021;101
1937;257;55,074867;10,467835;1882;1953;71
1937;270;56,302138;10,477471;1894;2021;127
1937;271;54,986632;9,977204;1920;2002;82
1937;294;55,471013;9,099652;1865;2021;156
1937;301;55,643464;9,651961;1889;2021;132
1937;308;55,671645;9,5777;1867;1939;72
1937;315;56,552152;9,40118;1868;2021;153
1937;322;54,9748134;12,2737822;1866;2021;155
1937;326;54,934174;9,248837;1905;1951;46
1937;328;54,873518;9,518945;1921;2021;100
1937;333;57,005237;9,774809;1915;1990;75
1937;336;56,032176;10,125522;1869;2005;136
1937;346;56,067076;10,134812;1866;2021;155
1937;13;55,18902;14,96054;1867;2021;154
1937;23;55,48022;8,43888;1910;2012;102
1937;29;56,328077;10,04661;1876;2021;145
1937;115;55,88581;12,51109;1905;1958;53
1937;130;55,67057;11,18151;1899;2021;122
1937;190;55,28738;11,55875;1934;1940;6
1937;191;55,1839;11,98427;1867;1947;80
1937;208;55,74166;11,41925;1865;2021;156
1937;219;55,66464;12,09277;1930;2001;71
1937;235;56,14912;9,91448;1868;1939;71
1937;243;55,3931;11,36045;1909;1973;64
1937;252;55,2722;12,32416;1894;1953;59
1937;304;55,72746;9,53248;1879;1942;63
1937;337;56,13962;10,20498;1928;2004;76
1938;6;55,269626;10,11524;1877;2009;132
1938;7;55,325496;10,197316;1906;1976;70
1938;19;57,141564;10,224039;1873;1974;101
1938;34;55,3214857;11,9687601;1891;1987;96
1938;35;55,3225039;11,9608428;1920;2010;90
1938;55;55,242371;10,53961;1866;2021;155
1938;69;55,182844;9,45901;1920;2004;84
1938;73;55,84433;9,589121;1848;2021;173
1938;74;55,714019;9,683858;1930;1972;42
1938;75;55,731027;9,833955;1866;1939;73
1938;77;56,028439;12,589834;1921;2021;100
1938;87;55,941434;12,268503;1937;2021;84
1938;88;55,944946;12,309925;1923;2021;98
1938;90;57,562284;9,986481;1891;1967;76
1938;93;57,356497;9,936222;1890;2021;131
1938;98;55,613092;11,778498;1928;1952;24
1938;110;55,965642;9,717756;1884;2006;122
1938;126;57,16496;9,729678;1877;1951;74
1938;140;55,585667;9,423096;1899;1961;62
1938;144;55,673798;12,577517;1891;2021;130
1938;145;55,682456;12,569828;1877;2021;144
1938;151;54,861238;10,73061;1867;1978;111
1938;155;56,557877;8,412895;1887;1976;89
1938;158;54,815811;11,264489;1905;1996;91
1938;168;55,51314;9,764369;1932;1978;46
1938;176;55,460727;9,822756;1880;1960;80
1938;177;56,839448;8,717907;1864;1946;82
1938;180;56,367177;10,746981;1897;1940;43
1938;182;56,453059;10,866897;1868;1938;70
1938;188;55,513946;10,178703;1882;1938;56
1938;195;55,9775064;10,1756177;1890;2021;131
1938;205;55,790358;11,464283;1907;1972;65
1938;213;56,833601;10,113311;1885;1939;54
1938;215;56,886164;9,836899;1886;2009;123
1938;236;56,090396;9,758625;1892;2021;129
1938;239;56,572888;9,051158;1907;2021;114
1938;256;55,070962;10,511664;1920;2021;101
1938;257;55,074867;10,467835;1882;1953;71
1938;270;56,302138;10,477471;1894;2021;127
1938;271;54,986632;9,977204;1920;2002;82
1938;294;55,471013;9,099652;1865;2021;156
1938;301;55,643464;9,651961;1889;2021;132
1938;308;55,671645;9,5777;1867;1939;72
1938;315;56,552152;9,40118;1868;2021;153
1938;322;54,9748134;12,2737822;1866;2021;155
1938;326;54,934174;9,248837;1905;1951;46
1938;328;54,873518;9,518945;1921;2021;100
1938;333;57,005237;9,774809;1915;1990;75
1938;336;56,032176;10,125522;1869;2005;136
1938;346;56,067076;10,134812;1866;2021;155
1938;13;55,18902;14,96054;1867;2021;154
1938;23;55,48022;8,43888;1910;2012;102
1938;29;56,328077;10,04661;1876;2021;145
1938;115;55,88581;12,51109;1905;1958;53
1938;130;55,67057;11,18151;1899;2021;122
1938;190;55,28738;11,55875;1934;1940;6
1938;191;55,1839;11,98427;1867;1947;80
1938;208;55,74166;11,41925;1865;2021;156
1938;219;55,66464;12,09277;1930;2001;71
1938;235;56,14912;9,91448;1868;1939;71
1938;243;55,3931;11,36045;1909;1973;64
1938;245;55,35164;11,32714;1938;2021;83
1938;252;55,2722;12,32416;1894;1953;59
1938;304;55,72746;9,53248;1879;1942;63
1938;337;56,13962;10,20498;1928;2004;76
1939;6;55,269626;10,11524;1877;2009;132
1939;7;55,325496;10,197316;1906;1976;70
1939;19;57,141564;10,224039;1873;1974;101
1939;34;55,3214857;11,9687601;1891;1987;96
1939;35;55,3225039;11,9608428;1920;2010;90
1939;55;55,242371;10,53961;1866;2021;155
1939;69;55,182844;9,45901;1920;2004;84
1939;73;55,84433;9,589121;1848;2021;173
1939;74;55,714019;9,683858;1930;1972;42
1939;75;55,731027;9,833955;1866;1939;73
1939;77;56,028439;12,589834;1921;2021;100
1939;87;55,941434;12,268503;1937;2021;84
1939;88;55,944946;12,309925;1923;2021;98
1939;90;57,562284;9,986481;1891;1967;76
1939;93;57,356497;9,936222;1890;2021;131
1939;98;55,613092;11,778498;1928;1952;24
1939;110;55,965642;9,717756;1884;2006;122
1939;126;57,16496;9,729678;1877;1951;74
1939;140;55,585667;9,423096;1899;1961;62
1939;144;55,673798;12,577517;1891;2021;130
1939;145;55,682456;12,569828;1877;2021;144
1939;151;54,861238;10,73061;1867;1978;111
1939;155;56,557877;8,412895;1887;1976;89
1939;158;54,815811;11,264489;1905;1996;91
1939;168;55,51314;9,764369;1932;1978;46
1939;176;55,460727;9,822756;1880;1960;80
1939;177;56,839448;8,717907;1864;1946;82
1939;180;56,367177;10,746981;1897;1940;43
1939;195;55,9775064;10,1756177;1890;2021;131
1939;205;55,790358;11,464283;1907;1972;65
1939;213;56,833601;10,113311;1885;1939;54
1939;215;56,886164;9,836899;1886;2009;123
1939;236;56,090396;9,758625;1892;2021;129
1939;239;56,572888;9,051158;1907;2021;114
1939;256;55,070962;10,511664;1920;2021;101
1939;257;55,074867;10,467835;1882;1953;71
1939;270;56,302138;10,477471;1894;2021;127
1939;271;54,986632;9,977204;1920;2002;82
1939;294;55,471013;9,099652;1865;2021;156
1939;301;55,643464;9,651961;1889;2021;132
1939;308;55,671645;9,5777;1867;1939;72
1939;315;56,552152;9,40118;1868;2021;153
1939;322;54,9748134;12,2737822;1866;2021;155
1939;326;54,934174;9,248837;1905;1951;46
1939;328;54,873518;9,518945;1921;2021;100
1939;333;57,005237;9,774809;1915;1990;75
1939;336;56,032176;10,125522;1869;2005;136
1939;346;56,067076;10,134812;1866;2021;155
1939;13;55,18902;14,96054;1867;2021;154
1939;23;55,48022;8,43888;1910;2012;102
1939;29;56,328077;10,04661;1876;2021;145
1939;115;55,88581;12,51109;1905;1958;53
1939;130;55,67057;11,18151;1899;2021;122
1939;190;55,28738;11,55875;1934;1940;6
1939;191;55,1839;11,98427;1867;1947;80
1939;208;55,74166;11,41925;1865;2021;156
1939;219;55,66464;12,09277;1930;2001;71
1939;235;56,14912;9,91448;1868;1939;71
1939;243;55,3931;11,36045;1909;1973;64
1939;245;55,35164;11,32714;1938;2021;83
1939;252;55,2722;12,32416;1894;1953;59
1939;304;55,72746;9,53248;1879;1942;63
1939;337;56,13962;10,20498;1928;2004;76
1940;6;55,269626;10,11524;1877;2009;132
1940;7;55,325496;10,197316;1906;1976;70
1940;19;57,141564;10,224039;1873;1974;101
1940;34;55,3214857;11,9687601;1891;1987;96
1940;35;55,3225039;11,9608428;1920;2010;90
1940;55;55,242371;10,53961;1866;2021;155
1940;69;55,182844;9,45901;1920;2004;84
1940;73;55,84433;9,589121;1848;2021;173
1940;74;55,714019;9,683858;1930;1972;42
1940;77;56,028439;12,589834;1921;2021;100
1940;87;55,941434;12,268503;1937;2021;84
1940;88;55,944946;12,309925;1923;2021;98
1940;90;57,562284;9,986481;1891;1967;76
1940;93;57,356497;9,936222;1890;2021;131
1940;98;55,613092;11,778498;1928;1952;24
1940;110;55,965642;9,717756;1884;2006;122
1940;126;57,16496;9,729678;1877;1951;74
1940;140;55,585667;9,423096;1899;1961;62
1940;144;55,673798;12,577517;1891;2021;130
1940;145;55,682456;12,569828;1877;2021;144
1940;151;54,861238;10,73061;1867;1978;111
1940;155;56,557877;8,412895;1887;1976;89
1940;158;54,815811;11,264489;1905;1996;91
1940;168;55,51314;9,764369;1932;1978;46
1940;176;55,460727;9,822756;1880;1960;80
1940;177;56,839448;8,717907;1864;1946;82
1940;180;56,367177;10,746981;1897;1940;43
1940;195;55,9775064;10,1756177;1890;2021;131
1940;205;55,790358;11,464283;1907;1972;65
1940;215;56,886164;9,836899;1886;2009;123
1940;236;56,090396;9,758625;1892;2021;129
1940;239;56,572888;9,051158;1907;2021;114
1940;256;55,070962;10,511664;1920;2021;101
1940;257;55,074867;10,467835;1882;1953;71
1940;270;56,302138;10,477471;1894;2021;127
1940;271;54,986632;9,977204;1920;2002;82
1940;294;55,471013;9,099652;1865;2021;156
1940;301;55,643464;9,651961;1889;2021;132
1940;302;55,715222;9,319221;1940;2021;81
1940;315;56,552152;9,40118;1868;2021;153
1940;322;54,9748134;12,2737822;1866;2021;155
1940;326;54,934174;9,248837;1905;1951;46
1940;328;54,873518;9,518945;1921;2021;100
1940;333;57,005237;9,774809;1915;1990;75
1940;336;56,032176;10,125522;1869;2005;136
1940;346;56,067076;10,134812;1866;2021;155
1940;13;55,18902;14,96054;1867;2021;154
1940;23;55,48022;8,43888;1910;2012;102
1940;29;56,328077;10,04661;1876;2021;145
1940;115;55,88581;12,51109;1905;1958;53
1940;130;55,67057;11,18151;1899;2021;122
1940;190;55,28738;11,55875;1934;1940;6
1940;191;55,1839;11,98427;1867;1947;80
1940;208;55,74166;11,41925;1865;2021;156
1940;219;55,66464;12,09277;1930;2001;71
1940;243;55,3931;11,36045;1909;1973;64
1940;245;55,35164;11,32714;1938;2021;83
1940;252;55,2722;12,32416;1894;1953;59
1940;304;55,72746;9,53248;1879;1942;63
1940;337;56,13962;10,20498;1928;2004;76
1941;6;55,269626;10,11524;1877;2009;132
1941;7;55,325496;10,197316;1906;1976;70
1941;19;57,141564;10,224039;1873;1974;101
1941;34;55,3214857;11,9687601;1891;1987;96
1941;35;55,3225039;11,9608428;1920;2010;90
1941;55;55,242371;10,53961;1866;2021;155
1941;69;55,182844;9,45901;1920;2004;84
1941;73;55,84433;9,589121;1848;2021;173
1941;74;55,714019;9,683858;1930;1972;42
1941;77;56,028439;12,589834;1921;2021;100
1941;87;55,941434;12,268503;1937;2021;84
1941;88;55,944946;12,309925;1923;2021;98
1941;90;57,562284;9,986481;1891;1967;76
1941;93;57,356497;9,936222;1890;2021;131
1941;98;55,613092;11,778498;1928;1952;24
1941;110;55,965642;9,717756;1884;2006;122
1941;126;57,16496;9,729678;1877;1951;74
1941;140;55,585667;9,423096;1899;1961;62
1941;144;55,673798;12,577517;1891;2021;130
1941;145;55,682456;12,569828;1877;2021;144
1941;151;54,861238;10,73061;1867;1978;111
1941;155;56,557877;8,412895;1887;1976;89
1941;158;54,815811;11,264489;1905;1996;91
1941;168;55,51314;9,764369;1932;1978;46
1941;176;55,460727;9,822756;1880;1960;80
1941;177;56,839448;8,717907;1864;1946;82
1941;195;55,9775064;10,1756177;1890;2021;131
1941;205;55,790358;11,464283;1907;1972;65
1941;215;56,886164;9,836899;1886;2009;123
1941;236;56,090396;9,758625;1892;2021;129
1941;239;56,572888;9,051158;1907;2021;114
1941;256;55,070962;10,511664;1920;2021;101
1941;257;55,074867;10,467835;1882;1953;71
1941;270;56,302138;10,477471;1894;2021;127
1941;271;54,986632;9,977204;1920;2002;82
1941;294;55,471013;9,099652;1865;2021;156
1941;301;55,643464;9,651961;1889;2021;132
1941;302;55,715222;9,319221;1940;2021;81
1941;315;56,552152;9,40118;1868;2021;153
1941;322;54,9748134;12,2737822;1866;2021;155
1941;326;54,934174;9,248837;1905;1951;46
1941;328;54,873518;9,518945;1921;2021;100
1941;333;57,005237;9,774809;1915;1990;75
1941;336;56,032176;10,125522;1869;2005;136
1941;346;56,067076;10,134812;1866;2021;155
1941;13;55,18902;14,96054;1867;2021;154
1941;23;55,48022;8,43888;1910;2012;102
1941;29;56,328077;10,04661;1876;2021;145
1941;115;55,88581;12,51109;1905;1958;53
1941;130;55,67057;11,18151;1899;2021;122
1941;191;55,1839;11,98427;1867;1947;80
1941;208;55,74166;11,41925;1865;2021;156
1941;219;55,66464;12,09277;1930;2001;71
1941;243;55,3931;11,36045;1909;1973;64
1941;245;55,35164;11,32714;1938;2021;83
1941;252;55,2722;12,32416;1894;1953;59
1941;304;55,72746;9,53248;1879;1942;63
1941;337;56,13962;10,20498;1928;2004;76
1942;6;55,269626;10,11524;1877;2009;132
1942;7;55,325496;10,197316;1906;1976;70
1942;19;57,141564;10,224039;1873;1974;101
1942;34;55,3214857;11,9687601;1891;1987;96
1942;35;55,3225039;11,9608428;1920;2010;90
1942;42;55,676442;12,508319;1942;1955;13
1942;55;55,242371;10,53961;1866;2021;155
1942;69;55,182844;9,45901;1920;2004;84
1942;73;55,84433;9,589121;1848;2021;173
1942;74;55,714019;9,683858;1930;1972;42
1942;77;56,028439;12,589834;1921;2021;100
1942;87;55,941434;12,268503;1937;2021;84
1942;88;55,944946;12,309925;1923;2021;98
1942;90;57,562284;9,986481;1891;1967;76
1942;93;57,356497;9,936222;1890;2021;131
1942;98;55,613092;11,778498;1928;1952;24
1942;110;55,965642;9,717756;1884;2006;122
1942;126;57,16496;9,729678;1877;1951;74
1942;140;55,585667;9,423096;1899;1961;62
1942;144;55,673798;12,577517;1891;2021;130
1942;145;55,682456;12,569828;1877;2021;144
1942;151;54,861238;10,73061;1867;1978;111
1942;155;56,557877;8,412895;1887;1976;89
1942;158;54,815811;11,264489;1905;1996;91
1942;168;55,51314;9,764369;1932;1978;46
1942;176;55,460727;9,822756;1880;1960;80
1942;177;56,839448;8,717907;1864;1946;82
1942;195;55,9775064;10,1756177;1890;2021;131
1942;205;55,790358;11,464283;1907;1972;65
1942;215;56,886164;9,836899;1886;2009;123
1942;236;56,090396;9,758625;1892;2021;129
1942;239;56,572888;9,051158;1907;2021;114
1942;256;55,070962;10,511664;1920;2021;101
1942;257;55,074867;10,467835;1882;1953;71
1942;270;56,302138;10,477471;1894;2021;127
1942;271;54,986632;9,977204;1920;2002;82
1942;294;55,471013;9,099652;1865;2021;156
1942;301;55,643464;9,651961;1889;2021;132
1942;302;55,715222;9,319221;1940;2021;81
1942;315;56,552152;9,40118;1868;2021;153
1942;322;54,9748134;12,2737822;1866;2021;155
1942;326;54,934174;9,248837;1905;1951;46
1942;328;54,873518;9,518945;1921;2021;100
1942;333;57,005237;9,774809;1915;1990;75
1942;336;56,032176;10,125522;1869;2005;136
1942;346;56,067076;10,134812;1866;2021;155
1942;13;55,18902;14,96054;1867;2021;154
1942;23;55,48022;8,43888;1910;2012;102
1942;29;56,328077;10,04661;1876;2021;145
1942;115;55,88581;12,51109;1905;1958;53
1942;130;55,67057;11,18151;1899;2021;122
1942;191;55,1839;11,98427;1867;1947;80
1942;208;55,74166;11,41925;1865;2021;156
1942;219;55,66464;12,09277;1930;2001;71
1942;243;55,3931;11,36045;1909;1973;64
1942;245;55,35164;11,32714;1938;2021;83
1942;252;55,2722;12,32416;1894;1953;59
1942;304;55,72746;9,53248;1879;1942;63
1942;337;56,13962;10,20498;1928;2004;76
1943;6;55,269626;10,11524;1877;2009;132
1943;7;55,325496;10,197316;1906;1976;70
1943;19;57,141564;10,224039;1873;1974;101
1943;34;55,3214857;11,9687601;1891;1987;96
1943;35;55,3225039;11,9608428;1920;2010;90
1943;42;55,676442;12,508319;1942;1955;13
1943;55;55,242371;10,53961;1866;2021;155
1943;69;55,182844;9,45901;1920;2004;84
1943;73;55,84433;9,589121;1848;2021;173
1943;74;55,714019;9,683858;1930;1972;42
1943;77;56,028439;12,589834;1921;2021;100
1943;87;55,941434;12,268503;1937;2021;84
1943;88;55,944946;12,309925;1923;2021;98
1943;90;57,562284;9,986481;1891;1967;76
1943;93;57,356497;9,936222;1890;2021;131
1943;98;55,613092;11,778498;1928;1952;24
1943;110;55,965642;9,717756;1884;2006;122
1943;126;57,16496;9,729678;1877;1951;74
1943;140;55,585667;9,423096;1899;1961;62
1943;144;55,673798;12,577517;1891;2021;130
1943;145;55,682456;12,569828;1877;2021;144
1943;151;54,861238;10,73061;1867;1978;111
1943;155;56,557877;8,412895;1887;1976;89
1943;158;54,815811;11,264489;1905;1996;91
1943;168;55,51314;9,764369;1932;1978;46
1943;176;55,460727;9,822756;1880;1960;80
1943;177;56,839448;8,717907;1864;1946;82
1943;195;55,9775064;10,1756177;1890;2021;131
1943;205;55,790358;11,464283;1907;1972;65
1943;215;56,886164;9,836899;1886;2009;123
1943;236;56,090396;9,758625;1892;2021;129
1943;239;56,572888;9,051158;1907;2021;114
1943;256;55,070962;10,511664;1920;2021;101
1943;257;55,074867;10,467835;1882;1953;71
1943;270;56,302138;10,477471;1894;2021;127
1943;271;54,986632;9,977204;1920;2002;82
1943;294;55,471013;9,099652;1865;2021;156
1943;301;55,643464;9,651961;1889;2021;132
1943;302;55,715222;9,319221;1940;2021;81
1943;307;55,716877;9,585268;1943;2021;78
1943;315;56,552152;9,40118;1868;2021;153
1943;322;54,9748134;12,2737822;1866;2021;155
1943;326;54,934174;9,248837;1905;1951;46
1943;328;54,873518;9,518945;1921;2021;100
1943;333;57,005237;9,774809;1915;1990;75
1943;336;56,032176;10,125522;1869;2005;136
1943;346;56,067076;10,134812;1866;2021;155
1943;13;55,18902;14,96054;1867;2021;154
1943;23;55,48022;8,43888;1910;2012;102
1943;29;56,328077;10,04661;1876;2021;145
1943;115;55,88581;12,51109;1905;1958;53
1943;130;55,67057;11,18151;1899;2021;122
1943;191;55,1839;11,98427;1867;1947;80
1943;208;55,74166;11,41925;1865;2021;156
1943;219;55,66464;12,09277;1930;2001;71
1943;243;55,3931;11,36045;1909;1973;64
1943;245;55,35164;11,32714;1938;2021;83
1943;252;55,2722;12,32416;1894;1953;59
1943;337;56,13962;10,20498;1928;2004;76
1944;6;55,269626;10,11524;1877;2009;132
1944;7;55,325496;10,197316;1906;1976;70
1944;19;57,141564;10,224039;1873;1974;101
1944;34;55,3214857;11,9687601;1891;1987;96
1944;35;55,3225039;11,9608428;1920;2010;90
1944;42;55,676442;12,508319;1942;1955;13
1944;55;55,242371;10,53961;1866;2021;155
1944;69;55,182844;9,45901;1920;2004;84
1944;73;55,84433;9,589121;1848;2021;173
1944;74;55,714019;9,683858;1930;1972;42
1944;77;56,028439;12,589834;1921;2021;100
1944;87;55,941434;12,268503;1937;2021;84
1944;88;55,944946;12,309925;1923;2021;98
1944;90;57,562284;9,986481;1891;1967;76
1944;93;57,356497;9,936222;1890;2021;131
1944;98;55,613092;11,778498;1928;1952;24
1944;110;55,965642;9,717756;1884;2006;122
1944;126;57,16496;9,729678;1877;1951;74
1944;140;55,585667;9,423096;1899;1961;62
1944;144;55,673798;12,577517;1891;2021;130
1944;145;55,682456;12,569828;1877;2021;144
1944;151;54,861238;10,73061;1867;1978;111
1944;155;56,557877;8,412895;1887;1976;89
1944;158;54,815811;11,264489;1905;1996;91
1944;168;55,51314;9,764369;1932;1978;46
1944;176;55,460727;9,822756;1880;1960;80
1944;177;56,839448;8,717907;1864;1946;82
1944;195;55,9775064;10,1756177;1890;2021;131
1944;205;55,790358;11,464283;1907;1972;65
1944;215;56,886164;9,836899;1886;2009;123
1944;236;56,090396;9,758625;1892;2021;129
1944;239;56,572888;9,051158;1907;2021;114
1944;256;55,070962;10,511664;1920;2021;101
1944;257;55,074867;10,467835;1882;1953;71
1944;270;56,302138;10,477471;1894;2021;127
1944;271;54,986632;9,977204;1920;2002;82
1944;294;55,471013;9,099652;1865;2021;156
1944;301;55,643464;9,651961;1889;2021;132
1944;302;55,715222;9,319221;1940;2021;81
1944;307;55,716877;9,585268;1943;2021;78
1944;315;56,552152;9,40118;1868;2021;153
1944;322;54,9748134;12,2737822;1866;2021;155
1944;326;54,934174;9,248837;1905;1951;46
1944;328;54,873518;9,518945;1921;2021;100
1944;333;57,005237;9,774809;1915;1990;75
1944;336;56,032176;10,125522;1869;2005;136
1944;346;56,067076;10,134812;1866;2021;155
1944;13;55,18902;14,96054;1867;2021;154
1944;23;55,48022;8,43888;1910;2012;102
1944;29;56,328077;10,04661;1876;2021;145
1944;115;55,88581;12,51109;1905;1958;53
1944;130;55,67057;11,18151;1899;2021;122
1944;191;55,1839;11,98427;1867;1947;80
1944;208;55,74166;11,41925;1865;2021;156
1944;219;55,66464;12,09277;1930;2001;71
1944;243;55,3931;11,36045;1909;1973;64
1944;245;55,35164;11,32714;1938;2021;83
1944;252;55,2722;12,32416;1894;1953;59
1944;337;56,13962;10,20498;1928;2004;76
1945;6;55,269626;10,11524;1877;2009;132
1945;7;55,325496;10,197316;1906;1976;70
1945;19;57,141564;10,224039;1873;1974;101
1945;34;55,3214857;11,9687601;1891;1987;96
1945;35;55,3225039;11,9608428;1920;2010;90
1945;42;55,676442;12,508319;1942;1955;13
1945;55;55,242371;10,53961;1866;2021;155
1945;69;55,182844;9,45901;1920;2004;84
1945;73;55,84433;9,589121;1848;2021;173
1945;74;55,714019;9,683858;1930;1972;42
1945;77;56,028439;12,589834;1921;2021;100
1945;87;55,941434;12,268503;1937;2021;84
1945;88;55,944946;12,309925;1923;2021;98
1945;90;57,562284;9,986481;1891;1967;76
1945;93;57,356497;9,936222;1890;2021;131
1945;98;55,613092;11,778498;1928;1952;24
1945;110;55,965642;9,717756;1884;2006;122
1945;126;57,16496;9,729678;1877;1951;74
1945;140;55,585667;9,423096;1899;1961;62
1945;144;55,673798;12,577517;1891;2021;130
1945;145;55,682456;12,569828;1877;2021;144
1945;151;54,861238;10,73061;1867;1978;111
1945;155;56,557877;8,412895;1887;1976;89
1945;158;54,815811;11,264489;1905;1996;91
1945;168;55,51314;9,764369;1932;1978;46
1945;176;55,460727;9,822756;1880;1960;80
1945;177;56,839448;8,717907;1864;1946;82
1945;195;55,9775064;10,1756177;1890;2021;131
1945;205;55,790358;11,464283;1907;1972;65
1945;215;56,886164;9,836899;1886;2009;123
1945;236;56,090396;9,758625;1892;2021;129
1945;239;56,572888;9,051158;1907;2021;114
1945;256;55,070962;10,511664;1920;2021;101
1945;257;55,074867;10,467835;1882;1953;71
1945;270;56,302138;10,477471;1894;2021;127
1945;271;54,986632;9,977204;1920;2002;82
1945;294;55,471013;9,099652;1865;2021;156
1945;301;55,643464;9,651961;1889;2021;132
1945;302;55,715222;9,319221;1940;2021;81
1945;307;55,716877;9,585268;1943;2021;78
1945;315;56,552152;9,40118;1868;2021;153
1945;322;54,9748134;12,2737822;1866;2021;155
1945;326;54,934174;9,248837;1905;1951;46
1945;328;54,873518;9,518945;1921;2021;100
1945;333;57,005237;9,774809;1915;1990;75
1945;336;56,032176;10,125522;1869;2005;136
1945;346;56,067076;10,134812;1866;2021;155
1945;13;55,18902;14,96054;1867;2021;154
1945;23;55,48022;8,43888;1910;2012;102
1945;29;56,328077;10,04661;1876;2021;145
1945;115;55,88581;12,51109;1905;1958;53
1945;130;55,67057;11,18151;1899;2021;122
1945;191;55,1839;11,98427;1867;1947;80
1945;208;55,74166;11,41925;1865;2021;156
1945;219;55,66464;12,09277;1930;2001;71
1945;243;55,3931;11,36045;1909;1973;64
1945;245;55,35164;11,32714;1938;2021;83
1945;252;55,2722;12,32416;1894;1953;59
1945;337;56,13962;10,20498;1928;2004;76
1946;6;55,269626;10,11524;1877;2009;132
1946;7;55,325496;10,197316;1906;1976;70
1946;19;57,141564;10,224039;1873;1974;101
1946;25;55,480218;8,438879;1946;1955;9
1946;34;55,3214857;11,9687601;1891;1987;96
1946;35;55,3225039;11,9608428;1920;2010;90
1946;38;55,973541;12,534777;1946;2021;75
1946;42;55,676442;12,508319;1942;1955;13
1946;55;55,242371;10,53961;1866;2021;155
1946;69;55,182844;9,45901;1920;2004;84
1946;73;55,84433;9,589121;1848;2021;173
1946;74;55,714019;9,683858;1930;1972;42
1946;77;56,028439;12,589834;1921;2021;100
1946;87;55,941434;12,268503;1937;2021;84
1946;88;55,944946;12,309925;1923;2021;98
1946;90;57,562284;9,986481;1891;1967;76
1946;93;57,356497;9,936222;1890;2021;131
1946;98;55,613092;11,778498;1928;1952;24
1946;110;55,965642;9,717756;1884;2006;122
1946;126;57,16496;9,729678;1877;1951;74
1946;140;55,585667;9,423096;1899;1961;62
1946;144;55,673798;12,577517;1891;2021;130
1946;145;55,682456;12,569828;1877;2021;144
1946;151;54,861238;10,73061;1867;1978;111
1946;155;56,557877;8,412895;1887;1976;89
1946;158;54,815811;11,264489;1905;1996;91
1946;168;55,51314;9,764369;1932;1978;46
1946;176;55,460727;9,822756;1880;1960;80
1946;177;56,839448;8,717907;1864;1946;82
1946;195;55,9775064;10,1756177;1890;2021;131
1946;205;55,790358;11,464283;1907;1972;65
1946;215;56,886164;9,836899;1886;2009;123
1946;236;56,090396;9,758625;1892;2021;129
1946;239;56,572888;9,051158;1907;2021;114
1946;256;55,070962;10,511664;1920;2021;101
1946;257;55,074867;10,467835;1882;1953;71
1946;270;56,302138;10,477471;1894;2021;127
1946;271;54,986632;9,977204;1920;2002;82
1946;294;55,471013;9,099652;1865;2021;156
1946;301;55,643464;9,651961;1889;2021;132
1946;302;55,715222;9,319221;1940;2021;81
1946;307;55,716877;9,585268;1943;2021;78
1946;315;56,552152;9,40118;1868;2021;153
1946;322;54,9748134;12,2737822;1866;2021;155
1946;326;54,934174;9,248837;1905;1951;46
1946;328;54,873518;9,518945;1921;2021;100
1946;333;57,005237;9,774809;1915;1990;75
1946;336;56,032176;10,125522;1869;2005;136
1946;346;56,067076;10,134812;1866;2021;155
1946;13;55,18902;14,96054;1867;2021;154
1946;23;55,48022;8,43888;1910;2012;102
1946;29;56,328077;10,04661;1876;2021;145
1946;115;55,88581;12,51109;1905;1958;53
1946;130;55,67057;11,18151;1899;2021;122
1946;191;55,1839;11,98427;1867;1947;80
1946;208;55,74166;11,41925;1865;2021;156
1946;219;55,66464;12,09277;1930;2001;71
1946;243;55,3931;11,36045;1909;1973;64
1946;245;55,35164;11,32714;1938;2021;83
1946;252;55,2722;12,32416;1894;1953;59
1946;337;56,13962;10,20498;1928;2004;76
1947;6;55,269626;10,11524;1877;2009;132
1947;7;55,325496;10,197316;1906;1976;70
1947;19;57,141564;10,224039;1873;1974;101
1947;25;55,480218;8,438879;1946;1955;9
1947;34;55,3214857;11,9687601;1891;1987;96
1947;35;55,3225039;11,9608428;1920;2010;90
1947;38;55,973541;12,534777;1946;2021;75
1947;42;55,676442;12,508319;1942;1955;13
1947;55;55,242371;10,53961;1866;2021;155
1947;69;55,182844;9,45901;1920;2004;84
1947;73;55,84433;9,589121;1848;2021;173
1947;74;55,714019;9,683858;1930;1972;42
1947;77;56,028439;12,589834;1921;2021;100
1947;87;55,941434;12,268503;1937;2021;84
1947;88;55,944946;12,309925;1923;2021;98
1947;90;57,562284;9,986481;1891;1967;76
1947;93;57,356497;9,936222;1890;2021;131
1947;98;55,613092;11,778498;1928;1952;24
1947;110;55,965642;9,717756;1884;2006;122
1947;126;57,16496;9,729678;1877;1951;74
1947;140;55,585667;9,423096;1899;1961;62
1947;144;55,673798;12,577517;1891;2021;130
1947;145;55,682456;12,569828;1877;2021;144
1947;151;54,861238;10,73061;1867;1978;111
1947;155;56,557877;8,412895;1887;1976;89
1947;158;54,815811;11,264489;1905;1996;91
1947;168;55,51314;9,764369;1932;1978;46
1947;176;55,460727;9,822756;1880;1960;80
1947;195;55,9775064;10,1756177;1890;2021;131
1947;205;55,790358;11,464283;1907;1972;65
1947;215;56,886164;9,836899;1886;2009;123
1947;236;56,090396;9,758625;1892;2021;129
1947;239;56,572888;9,051158;1907;2021;114
1947;256;55,070962;10,511664;1920;2021;101
1947;257;55,074867;10,467835;1882;1953;71
1947;270;56,302138;10,477471;1894;2021;127
1947;271;54,986632;9,977204;1920;2002;82
1947;294;55,471013;9,099652;1865;2021;156
1947;301;55,643464;9,651961;1889;2021;132
1947;302;55,715222;9,319221;1940;2021;81
1947;307;55,716877;9,585268;1943;2021;78
1947;315;56,552152;9,40118;1868;2021;153
1947;322;54,9748134;12,2737822;1866;2021;155
1947;326;54,934174;9,248837;1905;1951;46
1947;328;54,873518;9,518945;1921;2021;100
1947;333;57,005237;9,774809;1915;1990;75
1947;336;56,032176;10,125522;1869;2005;136
1947;346;56,067076;10,134812;1866;2021;155
1947;13;55,18902;14,96054;1867;2021;154
1947;23;55,48022;8,43888;1910;2012;102
1947;29;56,328077;10,04661;1876;2021;145
1947;115;55,88581;12,51109;1905;1958;53
1947;130;55,67057;11,18151;1899;2021;122
1947;191;55,1839;11,98427;1867;1947;80
1947;208;55,74166;11,41925;1865;2021;156
1947;219;55,66464;12,09277;1930;2001;71
1947;243;55,3931;11,36045;1909;1973;64
1947;245;55,35164;11,32714;1938;2021;83
1947;252;55,2722;12,32416;1894;1953;59
1947;337;56,13962;10,20498;1928;2004;76
1948;6;55,269626;10,11524;1877;2009;132
1948;7;55,325496;10,197316;1906;1976;70
1948;19;57,141564;10,224039;1873;1974;101
1948;25;55,480218;8,438879;1946;1955;9
1948;34;55,3214857;11,9687601;1891;1987;96
1948;35;55,3225039;11,9608428;1920;2010;90
1948;38;55,973541;12,534777;1946;2021;75
1948;42;55,676442;12,508319;1942;1955;13
1948;55;55,242371;10,53961;1866;2021;155
1948;69;55,182844;9,45901;1920;2004;84
1948;73;55,84433;9,589121;1848;2021;173
1948;74;55,714019;9,683858;1930;1972;42
1948;77;56,028439;12,589834;1921;2021;100
1948;87;55,941434;12,268503;1937;2021;84
1948;88;55,944946;12,309925;1923;2021;98
1948;89;57,4677313;9,8003389;1948;1950;2
1948;90;57,562284;9,986481;1891;1967;76
1948;93;57,356497;9,936222;1890;2021;131
1948;98;55,613092;11,778498;1928;1952;24
1948;110;55,965642;9,717756;1884;2006;122
1948;126;57,16496;9,729678;1877;1951;74
1948;140;55,585667;9,423096;1899;1961;62
1948;144;55,673798;12,577517;1891;2021;130
1948;145;55,682456;12,569828;1877;2021;144
1948;151;54,861238;10,73061;1867;1978;111
1948;155;56,557877;8,412895;1887;1976;89
1948;158;54,815811;11,264489;1905;1996;91
1948;168;55,51314;9,764369;1932;1978;46
1948;176;55,460727;9,822756;1880;1960;80
1948;195;55,9775064;10,1756177;1890;2021;131
1948;205;55,790358;11,464283;1907;1972;65
1948;215;56,886164;9,836899;1886;2009;123
1948;236;56,090396;9,758625;1892;2021;129
1948;239;56,572888;9,051158;1907;2021;114
1948;256;55,070962;10,511664;1920;2021;101
1948;257;55,074867;10,467835;1882;1953;71
1948;270;56,302138;10,477471;1894;2021;127
1948;271;54,986632;9,977204;1920;2002;82
1948;294;55,471013;9,099652;1865;2021;156
1948;301;55,643464;9,651961;1889;2021;132
1948;302;55,715222;9,319221;1940;2021;81
1948;307;55,716877;9,585268;1943;2021;78
1948;315;56,552152;9,40118;1868;2021;153
1948;322;54,9748134;12,2737822;1866;2021;155
1948;326;54,934174;9,248837;1905;1951;46
1948;328;54,873518;9,518945;1921;2021;100
1948;333;57,005237;9,774809;1915;1990;75
1948;336;56,032176;10,125522;1869;2005;136
1948;346;56,067076;10,134812;1866;2021;155
1948;13;55,18902;14,96054;1867;2021;154
1948;23;55,48022;8,43888;1910;2012;102
1948;29;56,328077;10,04661;1876;2021;145
1948;115;55,88581;12,51109;1905;1958;53
1948;130;55,67057;11,18151;1899;2021;122
1948;208;55,74166;11,41925;1865;2021;156
1948;219;55,66464;12,09277;1930;2001;71
1948;243;55,3931;11,36045;1909;1973;64
1948;245;55,35164;11,32714;1938;2021;83
1948;252;55,2722;12,32416;1894;1953;59
1948;337;56,13962;10,20498;1928;2004;76
1949;6;55,269626;10,11524;1877;2009;132
1949;7;55,325496;10,197316;1906;1976;70
1949;19;57,141564;10,224039;1873;1974;101
1949;25;55,480218;8,438879;1946;1955;9
1949;34;55,3214857;11,9687601;1891;1987;96
1949;35;55,3225039;11,9608428;1920;2010;90
1949;38;55,973541;12,534777;1946;2021;75
1949;42;55,676442;12,508319;1942;1955;13
1949;55;55,242371;10,53961;1866;2021;155
1949;69;55,182844;9,45901;1920;2004;84
1949;73;55,84433;9,589121;1848;2021;173
1949;74;55,714019;9,683858;1930;1972;42
1949;77;56,028439;12,589834;1921;2021;100
1949;87;55,941434;12,268503;1937;2021;84
1949;88;55,944946;12,309925;1923;2021;98
1949;89;57,4677313;9,8003389;1948;1950;2
1949;90;57,562284;9,986481;1891;1967;76
1949;93;57,356497;9,936222;1890;2021;131
1949;98;55,613092;11,778498;1928;1952;24
1949;110;55,965642;9,717756;1884;2006;122
1949;126;57,16496;9,729678;1877;1951;74
1949;135;55,482156;9,451854;1949;2021;72
1949;140;55,585667;9,423096;1899;1961;62
1949;144;55,673798;12,577517;1891;2021;130
1949;145;55,682456;12,569828;1877;2021;144
1949;151;54,861238;10,73061;1867;1978;111
1949;155;56,557877;8,412895;1887;1976;89
1949;158;54,815811;11,264489;1905;1996;91
1949;168;55,51314;9,764369;1932;1978;46
1949;176;55,460727;9,822756;1880;1960;80
1949;195;55,9775064;10,1756177;1890;2021;131
1949;205;55,790358;11,464283;1907;1972;65
1949;215;56,886164;9,836899;1886;2009;123
1949;236;56,090396;9,758625;1892;2021;129
1949;239;56,572888;9,051158;1907;2021;114
1949;256;55,070962;10,511664;1920;2021;101
1949;257;55,074867;10,467835;1882;1953;71
1949;270;56,302138;10,477471;1894;2021;127
1949;271;54,986632;9,977204;1920;2002;82
1949;294;55,471013;9,099652;1865;2021;156
1949;301;55,643464;9,651961;1889;2021;132
1949;302;55,715222;9,319221;1940;2021;81
1949;307;55,716877;9,585268;1943;2021;78
1949;315;56,552152;9,40118;1868;2021;153
1949;322;54,9748134;12,2737822;1866;2021;155
1949;326;54,934174;9,248837;1905;1951;46
1949;328;54,873518;9,518945;1921;2021;100
1949;333;57,005237;9,774809;1915;1990;75
1949;336;56,032176;10,125522;1869;2005;136
1949;346;56,067076;10,134812;1866;2021;155
1949;13;55,18902;14,96054;1867;2021;154
1949;23;55,48022;8,43888;1910;2012;102
1949;29;56,328077;10,04661;1876;2021;145
1949;115;55,88581;12,51109;1905;1958;53
1949;130;55,67057;11,18151;1899;2021;122
1949;208;55,74166;11,41925;1865;2021;156
1949;219;55,66464;12,09277;1930;2001;71
1949;243;55,3931;11,36045;1909;1973;64
1949;245;55,35164;11,32714;1938;2021;83
1949;252;55,2722;12,32416;1894;1953;59
1949;337;56,13962;10,20498;1928;2004;76
1950;6;55,269626;10,11524;1877;2009;132
1950;7;55,325496;10,197316;1906;1976;70
1950;19;57,141564;10,224039;1873;1974;101
1950;25;55,480218;8,438879;1946;1955;9
1950;34;55,3214857;11,9687601;1891;1987;96
1950;35;55,3225039;11,9608428;1920;2010;90
1950;38;55,973541;12,534777;1946;2021;75
1950;42;55,676442;12,508319;1942;1955;13
1950;55;55,242371;10,53961;1866;2021;155
1950;69;55,182844;9,45901;1920;2004;84
1950;73;55,84433;9,589121;1848;2021;173
1950;74;55,714019;9,683858;1930;1972;42
1950;77;56,028439;12,589834;1921;2021;100
1950;87;55,941434;12,268503;1937;2021;84
1950;88;55,944946;12,309925;1923;2021;98
1950;89;57,4677313;9,8003389;1948;1950;2
1950;90;57,562284;9,986481;1891;1967;76
1950;93;57,356497;9,936222;1890;2021;131
1950;98;55,613092;11,778498;1928;1952;24
1950;110;55,965642;9,717756;1884;2006;122
1950;126;57,16496;9,729678;1877;1951;74
1950;135;55,482156;9,451854;1949;2021;72
1950;140;55,585667;9,423096;1899;1961;62
1950;144;55,673798;12,577517;1891;2021;130
1950;145;55,682456;12,569828;1877;2021;144
1950;151;54,861238;10,73061;1867;1978;111
1950;155;56,557877;8,412895;1887;1976;89
1950;158;54,815811;11,264489;1905;1996;91
1950;168;55,51314;9,764369;1932;1978;46
1950;176;55,460727;9,822756;1880;1960;80
1950;195;55,9775064;10,1756177;1890;2021;131
1950;205;55,790358;11,464283;1907;1972;65
1950;215;56,886164;9,836899;1886;2009;123
1950;236;56,090396;9,758625;1892;2021;129
1950;239;56,572888;9,051158;1907;2021;114
1950;256;55,070962;10,511664;1920;2021;101
1950;257;55,074867;10,467835;1882;1953;71
1950;270;56,302138;10,477471;1894;2021;127
1950;271;54,986632;9,977204;1920;2002;82
1950;294;55,471013;9,099652;1865;2021;156
1950;301;55,643464;9,651961;1889;2021;132
1950;302;55,715222;9,319221;1940;2021;81
1950;307;55,716877;9,585268;1943;2021;78
1950;315;56,552152;9,40118;1868;2021;153
1950;322;54,9748134;12,2737822;1866;2021;155
1950;326;54,934174;9,248837;1905;1951;46
1950;328;54,873518;9,518945;1921;2021;100
1950;333;57,005237;9,774809;1915;1990;75
1950;336;56,032176;10,125522;1869;2005;136
1950;346;56,067076;10,134812;1866;2021;155
1950;13;55,18902;14,96054;1867;2021;154
1950;23;55,48022;8,43888;1910;2012;102
1950;29;56,328077;10,04661;1876;2021;145
1950;115;55,88581;12,51109;1905;1958;53
1950;130;55,67057;11,18151;1899;2021;122
1950;208;55,74166;11,41925;1865;2021;156
1950;219;55,66464;12,09277;1930;2001;71
1950;223;55,85422;12,46918;1950;1974;24
1950;243;55,3931;11,36045;1909;1973;64
1950;245;55,35164;11,32714;1938;2021;83
1950;252;55,2722;12,32416;1894;1953;59
1950;300;55,77169;9,47224;1950;1960;10
1950;337;56,13962;10,20498;1928;2004;76
1951;6;55,269626;10,11524;1877;2009;132
1951;7;55,325496;10,197316;1906;1976;70
1951;19;57,141564;10,224039;1873;1974;101
1951;25;55,480218;8,438879;1946;1955;9
1951;34;55,3214857;11,9687601;1891;1987;96
1951;35;55,3225039;11,9608428;1920;2010;90
1951;38;55,973541;12,534777;1946;2021;75
1951;42;55,676442;12,508319;1942;1955;13
1951;55;55,242371;10,53961;1866;2021;155
1951;69;55,182844;9,45901;1920;2004;84
1951;73;55,84433;9,589121;1848;2021;173
1951;74;55,714019;9,683858;1930;1972;42
1951;77;56,028439;12,589834;1921;2021;100
1951;87;55,941434;12,268503;1937;2021;84
1951;88;55,944946;12,309925;1923;2021;98
1951;90;57,562284;9,986481;1891;1967;76
1951;93;57,356497;9,936222;1890;2021;131
1951;98;55,613092;11,778498;1928;1952;24
1951;110;55,965642;9,717756;1884;2006;122
1951;126;57,16496;9,729678;1877;1951;74
1951;135;55,482156;9,451854;1949;2021;72
1951;140;55,585667;9,423096;1899;1961;62
1951;144;55,673798;12,577517;1891;2021;130
1951;145;55,682456;12,569828;1877;2021;144
1951;151;54,861238;10,73061;1867;1978;111
1951;155;56,557877;8,412895;1887;1976;89
1951;158;54,815811;11,264489;1905;1996;91
1951;168;55,51314;9,764369;1932;1978;46
1951;176;55,460727;9,822756;1880;1960;80
1951;195;55,9775064;10,1756177;1890;2021;131
1951;205;55,790358;11,464283;1907;1972;65
1951;215;56,886164;9,836899;1886;2009;123
1951;236;56,090396;9,758625;1892;2021;129
1951;239;56,572888;9,051158;1907;2021;114
1951;256;55,070962;10,511664;1920;2021;101
1951;257;55,074867;10,467835;1882;1953;71
1951;270;56,302138;10,477471;1894;2021;127
1951;271;54,986632;9,977204;1920;2002;82
1951;294;55,471013;9,099652;1865;2021;156
1951;301;55,643464;9,651961;1889;2021;132
1951;302;55,715222;9,319221;1940;2021;81
1951;307;55,716877;9,585268;1943;2021;78
1951;315;56,552152;9,40118;1868;2021;153
1951;316;56,441433;9,422904;1951;2021;70
1951;322;54,9748134;12,2737822;1866;2021;155
1951;326;54,934174;9,248837;1905;1951;46
1951;328;54,873518;9,518945;1921;2021;100
1951;333;57,005237;9,774809;1915;1990;75
1951;336;56,032176;10,125522;1869;2005;136
1951;346;56,067076;10,134812;1866;2021;155
1951;13;55,18902;14,96054;1867;2021;154
1951;23;55,48022;8,43888;1910;2012;102
1951;29;56,328077;10,04661;1876;2021;145
1951;115;55,88581;12,51109;1905;1958;53
1951;130;55,67057;11,18151;1899;2021;122
1951;208;55,74166;11,41925;1865;2021;156
1951;219;55,66464;12,09277;1930;2001;71
1951;223;55,85422;12,46918;1950;1974;24
1951;243;55,3931;11,36045;1909;1973;64
1951;245;55,35164;11,32714;1938;2021;83
1951;252;55,2722;12,32416;1894;1953;59
1951;300;55,77169;9,47224;1950;1960;10
1951;337;56,13962;10,20498;1928;2004;76
1952;6;55,269626;10,11524;1877;2009;132
1952;7;55,325496;10,197316;1906;1976;70
1952;19;57,141564;10,224039;1873;1974;101
1952;25;55,480218;8,438879;1946;1955;9
1952;34;55,3214857;11,9687601;1891;1987;96
1952;35;55,3225039;11,9608428;1920;2010;90
1952;38;55,973541;12,534777;1946;2021;75
1952;42;55,676442;12,508319;1942;1955;13
1952;55;55,242371;10,53961;1866;2021;155
1952;69;55,182844;9,45901;1920;2004;84
1952;73;55,84433;9,589121;1848;2021;173
1952;74;55,714019;9,683858;1930;1972;42
1952;77;56,028439;12,589834;1921;2021;100
1952;87;55,941434;12,268503;1937;2021;84
1952;88;55,944946;12,309925;1923;2021;98
1952;90;57,562284;9,986481;1891;1967;76
1952;93;57,356497;9,936222;1890;2021;131
1952;98;55,613092;11,778498;1928;1952;24
1952;110;55,965642;9,717756;1884;2006;122
1952;131;55,46168;10,663878;1952;2005;53
1952;135;55,482156;9,451854;1949;2021;72
1952;140;55,585667;9,423096;1899;1961;62
1952;144;55,673798;12,577517;1891;2021;130
1952;145;55,682456;12,569828;1877;2021;144
1952;151;54,861238;10,73061;1867;1978;111
1952;155;56,557877;8,412895;1887;1976;89
1952;158;54,815811;11,264489;1905;1996;91
1952;168;55,51314;9,764369;1932;1978;46
1952;176;55,460727;9,822756;1880;1960;80
1952;195;55,9775064;10,1756177;1890;2021;131
1952;205;55,790358;11,464283;1907;1972;65
1952;215;56,886164;9,836899;1886;2009;123
1952;236;56,090396;9,758625;1892;2021;129
1952;239;56,572888;9,051158;1907;2021;114
1952;256;55,070962;10,511664;1920;2021;101
1952;257;55,074867;10,467835;1882;1953;71
1952;270;56,302138;10,477471;1894;2021;127
1952;271;54,986632;9,977204;1920;2002;82
1952;273;54,898325;9,802925;1952;2021;69
1952;294;55,471013;9,099652;1865;2021;156
1952;301;55,643464;9,651961;1889;2021;132
1952;302;55,715222;9,319221;1940;2021;81
1952;307;55,716877;9,585268;1943;2021;78
1952;315;56,552152;9,40118;1868;2021;153
1952;316;56,441433;9,422904;1951;2021;70
1952;322;54,9748134;12,2737822;1866;2021;155
1952;328;54,873518;9,518945;1921;2021;100
1952;333;57,005237;9,774809;1915;1990;75
1952;336;56,032176;10,125522;1869;2005;136
1952;346;56,067076;10,134812;1866;2021;155
1952;13;55,18902;14,96054;1867;2021;154
1952;23;55,48022;8,43888;1910;2012;102
1952;29;56,328077;10,04661;1876;2021;145
1952;115;55,88581;12,51109;1905;1958;53
1952;130;55,67057;11,18151;1899;2021;122
1952;208;55,74166;11,41925;1865;2021;156
1952;219;55,66464;12,09277;1930;2001;71
1952;223;55,85422;12,46918;1950;1974;24
1952;243;55,3931;11,36045;1909;1973;64
1952;245;55,35164;11,32714;1938;2021;83
1952;252;55,2722;12,32416;1894;1953;59
1952;300;55,77169;9,47224;1950;1960;10
1952;337;56,13962;10,20498;1928;2004;76
1953;6;55,269626;10,11524;1877;2009;132
1953;7;55,325496;10,197316;1906;1976;70
1953;19;57,141564;10,224039;1873;1974;101
1953;25;55,480218;8,438879;1946;1955;9
1953;34;55,3214857;11,9687601;1891;1987;96
1953;35;55,3225039;11,9608428;1920;2010;90
1953;38;55,973541;12,534777;1946;2021;75
1953;42;55,676442;12,508319;1942;1955;13
1953;55;55,242371;10,53961;1866;2021;155
1953;69;55,182844;9,45901;1920;2004;84
1953;73;55,84433;9,589121;1848;2021;173
1953;74;55,714019;9,683858;1930;1972;42
1953;77;56,028439;12,589834;1921;2021;100
1953;87;55,941434;12,268503;1937;2021;84
1953;88;55,944946;12,309925;1923;2021;98
1953;90;57,562284;9,986481;1891;1967;76
1953;93;57,356497;9,936222;1890;2021;131
1953;110;55,965642;9,717756;1884;2006;122
1953;131;55,46168;10,663878;1952;2005;53
1953;135;55,482156;9,451854;1949;2021;72
1953;140;55,585667;9,423096;1899;1961;62
1953;144;55,673798;12,577517;1891;2021;130
1953;145;55,682456;12,569828;1877;2021;144
1953;151;54,861238;10,73061;1867;1978;111
1953;155;56,557877;8,412895;1887;1976;89
1953;158;54,815811;11,264489;1905;1996;91
1953;168;55,51314;9,764369;1932;1978;46
1953;176;55,460727;9,822756;1880;1960;80
1953;195;55,9775064;10,1756177;1890;2021;131
1953;205;55,790358;11,464283;1907;1972;65
1953;215;56,886164;9,836899;1886;2009;123
1953;236;56,090396;9,758625;1892;2021;129
1953;239;56,572888;9,051158;1907;2021;114
1953;256;55,070962;10,511664;1920;2021;101
1953;257;55,074867;10,467835;1882;1953;71
1953;270;56,302138;10,477471;1894;2021;127
1953;271;54,986632;9,977204;1920;2002;82
1953;273;54,898325;9,802925;1952;2021;69
1953;294;55,471013;9,099652;1865;2021;156
1953;301;55,643464;9,651961;1889;2021;132
1953;302;55,715222;9,319221;1940;2021;81
1953;307;55,716877;9,585268;1943;2021;78
1953;315;56,552152;9,40118;1868;2021;153
1953;316;56,441433;9,422904;1951;2021;70
1953;322;54,9748134;12,2737822;1866;2021;155
1953;328;54,873518;9,518945;1921;2021;100
1953;333;57,005237;9,774809;1915;1990;75
1953;336;56,032176;10,125522;1869;2005;136
1953;346;56,067076;10,134812;1866;2021;155
1953;13;55,18902;14,96054;1867;2021;154
1953;23;55,48022;8,43888;1910;2012;102
1953;29;56,328077;10,04661;1876;2021;145
1953;115;55,88581;12,51109;1905;1958;53
1953;130;55,67057;11,18151;1899;2021;122
1953;208;55,74166;11,41925;1865;2021;156
1953;219;55,66464;12,09277;1930;2001;71
1953;223;55,85422;12,46918;1950;1974;24
1953;243;55,3931;11,36045;1909;1973;64
1953;245;55,35164;11,32714;1938;2021;83
1953;252;55,2722;12,32416;1894;1953;59
1953;300;55,77169;9,47224;1950;1960;10
1953;337;56,13962;10,20498;1928;2004;76
1954;6;55,269626;10,11524;1877;2009;132
1954;7;55,325496;10,197316;1906;1976;70
1954;19;57,141564;10,224039;1873;1974;101
1954;25;55,480218;8,438879;1946;1955;9
1954;34;55,3214857;11,9687601;1891;1987;96
1954;35;55,3225039;11,9608428;1920;2010;90
1954;38;55,973541;12,534777;1946;2021;75
1954;42;55,676442;12,508319;1942;1955;13
1954;55;55,242371;10,53961;1866;2021;155
1954;69;55,182844;9,45901;1920;2004;84
1954;73;55,84433;9,589121;1848;2021;173
1954;74;55,714019;9,683858;1930;1972;42
1954;77;56,028439;12,589834;1921;2021;100
1954;87;55,941434;12,268503;1937;2021;84
1954;88;55,944946;12,309925;1923;2021;98
1954;90;57,562284;9,986481;1891;1967;76
1954;93;57,356497;9,936222;1890;2021;131
1954;110;55,965642;9,717756;1884;2006;122
1954;131;55,46168;10,663878;1952;2005;53
1954;135;55,482156;9,451854;1949;2021;72
1954;140;55,585667;9,423096;1899;1961;62
1954;144;55,673798;12,577517;1891;2021;130
1954;145;55,682456;12,569828;1877;2021;144
1954;151;54,861238;10,73061;1867;1978;111
1954;155;56,557877;8,412895;1887;1976;89
1954;158;54,815811;11,264489;1905;1996;91
1954;165;56,6472378;9,970264;1954;2021;67
1954;168;55,51314;9,764369;1932;1978;46
1954;176;55,460727;9,822756;1880;1960;80
1954;195;55,9775064;10,1756177;1890;2021;131
1954;199;55,373422;10,209279;1954;1971;17
1954;205;55,790358;11,464283;1907;1972;65
1954;215;56,886164;9,836899;1886;2009;123
1954;236;56,090396;9,758625;1892;2021;129
1954;239;56,572888;9,051158;1907;2021;114
1954;256;55,070962;10,511664;1920;2021;101
1954;270;56,302138;10,477471;1894;2021;127
1954;271;54,986632;9,977204;1920;2002;82
1954;273;54,898325;9,802925;1952;2021;69
1954;294;55,471013;9,099652;1865;2021;156
1954;301;55,643464;9,651961;1889;2021;132
1954;302;55,715222;9,319221;1940;2021;81
1954;307;55,716877;9,585268;1943;2021;78
1954;315;56,552152;9,40118;1868;2021;153
1954;316;56,441433;9,422904;1951;2021;70
1954;322;54,9748134;12,2737822;1866;2021;155
1954;328;54,873518;9,518945;1921;2021;100
1954;333;57,005237;9,774809;1915;1990;75
1954;336;56,032176;10,125522;1869;2005;136
1954;346;56,067076;10,134812;1866;2021;155
1954;13;55,18902;14,96054;1867;2021;154
1954;23;55,48022;8,43888;1910;2012;102
1954;29;56,328077;10,04661;1876;2021;145
1954;115;55,88581;12,51109;1905;1958;53
1954;130;55,67057;11,18151;1899;2021;122
1954;208;55,74166;11,41925;1865;2021;156
1954;219;55,66464;12,09277;1930;2001;71
1954;223;55,85422;12,46918;1950;1974;24
1954;243;55,3931;11,36045;1909;1973;64
1954;245;55,35164;11,32714;1938;2021;83
1954;300;55,77169;9,47224;1950;1960;10
1954;337;56,13962;10,20498;1928;2004;76
1955;6;55,269626;10,11524;1877;2009;132
1955;7;55,325496;10,197316;1906;1976;70
1955;19;57,141564;10,224039;1873;1974;101
1955;25;55,480218;8,438879;1946;1955;9
1955;31;56,327986;10,048241;1955;1972;17
1955;34;55,3214857;11,9687601;1891;1987;96
1955;35;55,3225039;11,9608428;1920;2010;90
1955;38;55,973541;12,534777;1946;2021;75
1955;42;55,676442;12,508319;1942;1955;13
1955;55;55,242371;10,53961;1866;2021;155
1955;69;55,182844;9,45901;1920;2004;84
1955;73;55,84433;9,589121;1848;2021;173
1955;74;55,714019;9,683858;1930;1972;42
1955;77;56,028439;12,589834;1921;2021;100
1955;87;55,941434;12,268503;1937;2021;84
1955;88;55,944946;12,309925;1923;2021;98
1955;90;57,562284;9,986481;1891;1967;76
1955;93;57,356497;9,936222;1890;2021;131
1955;110;55,965642;9,717756;1884;2006;122
1955;131;55,46168;10,663878;1952;2005;53
1955;135;55,482156;9,451854;1949;2021;72
1955;140;55,585667;9,423096;1899;1961;62
1955;144;55,673798;12,577517;1891;2021;130
1955;145;55,682456;12,569828;1877;2021;144
1955;151;54,861238;10,73061;1867;1978;111
1955;155;56,557877;8,412895;1887;1976;89
1955;158;54,815811;11,264489;1905;1996;91
1955;165;56,6472378;9,970264;1954;2021;67
1955;168;55,51314;9,764369;1932;1978;46
1955;172;55,506291;9,750979;1955;1964;9
1955;176;55,460727;9,822756;1880;1960;80
1955;195;55,9775064;10,1756177;1890;2021;131
1955;199;55,373422;10,209279;1954;1971;17
1955;205;55,790358;11,464283;1907;1972;65
1955;215;56,886164;9,836899;1886;2009;123
1955;236;56,090396;9,758625;1892;2021;129
1955;239;56,572888;9,051158;1907;2021;114
1955;256;55,070962;10,511664;1920;2021;101
1955;270;56,302138;10,477471;1894;2021;127
1955;271;54,986632;9,977204;1920;2002;82
1955;273;54,898325;9,802925;1952;2021;69
1955;294;55,471013;9,099652;1865;2021;156
1955;301;55,643464;9,651961;1889;2021;132
1955;302;55,715222;9,319221;1940;2021;81
1955;307;55,716877;9,585268;1943;2021;78
1955;315;56,552152;9,40118;1868;2021;153
1955;316;56,441433;9,422904;1951;2021;70
1955;322;54,9748134;12,2737822;1866;2021;155
1955;328;54,873518;9,518945;1921;2021;100
1955;333;57,005237;9,774809;1915;1990;75
1955;336;56,032176;10,125522;1869;2005;136
1955;346;56,067076;10,134812;1866;2021;155
1955;13;55,18902;14,96054;1867;2021;154
1955;23;55,48022;8,43888;1910;2012;102
1955;29;56,328077;10,04661;1876;2021;145
1955;115;55,88581;12,51109;1905;1958;53
1955;130;55,67057;11,18151;1899;2021;122
1955;203;55,44144;10,37108;1955;1981;26
1955;208;55,74166;11,41925;1865;2021;156
1955;219;55,66464;12,09277;1930;2001;71
1955;223;55,85422;12,46918;1950;1974;24
1955;243;55,3931;11,36045;1909;1973;64
1955;245;55,35164;11,32714;1938;2021;83
1955;300;55,77169;9,47224;1950;1960;10
1955;337;56,13962;10,20498;1928;2004;76
1956;6;55,269626;10,11524;1877;2009;132
1956;7;55,325496;10,197316;1906;1976;70
1956;19;57,141564;10,224039;1873;1974;101
1956;31;56,327986;10,048241;1955;1972;17
1956;34;55,3214857;11,9687601;1891;1987;96
1956;35;55,3225039;11,9608428;1920;2010;90
1956;38;55,973541;12,534777;1946;2021;75
1956;55;55,242371;10,53961;1866;2021;155
1956;69;55,182844;9,45901;1920;2004;84
1956;73;55,84433;9,589121;1848;2021;173
1956;74;55,714019;9,683858;1930;1972;42
1956;77;56,028439;12,589834;1921;2021;100
1956;87;55,941434;12,268503;1937;2021;84
1956;88;55,944946;12,309925;1923;2021;98
1956;90;57,562284;9,986481;1891;1967;76
1956;93;57,356497;9,936222;1890;2021;131
1956;110;55,965642;9,717756;1884;2006;122
1956;131;55,46168;10,663878;1952;2005;53
1956;135;55,482156;9,451854;1949;2021;72
1956;140;55,585667;9,423096;1899;1961;62
1956;144;55,673798;12,577517;1891;2021;130
1956;145;55,682456;12,569828;1877;2021;144
1956;151;54,861238;10,73061;1867;1978;111
1956;155;56,557877;8,412895;1887;1976;89
1956;158;54,815811;11,264489;1905;1996;91
1956;165;56,6472378;9,970264;1954;2021;67
1956;168;55,51314;9,764369;1932;1978;46
1956;172;55,506291;9,750979;1955;1964;9
1956;176;55,460727;9,822756;1880;1960;80
1956;194;55,92104;10,25164;1956;2021;65
1956;195;55,9775064;10,1756177;1890;2021;131
1956;199;55,373422;10,209279;1954;1971;17
1956;205;55,790358;11,464283;1907;1972;65
1956;215;56,886164;9,836899;1886;2009;123
1956;236;56,090396;9,758625;1892;2021;129
1956;239;56,572888;9,051158;1907;2021;114
1956;256;55,070962;10,511664;1920;2021;101
1956;270;56,302138;10,477471;1894;2021;127
1956;271;54,986632;9,977204;1920;2002;82
1956;273;54,898325;9,802925;1952;2021;69
1956;294;55,471013;9,099652;1865;2021;156
1956;301;55,643464;9,651961;1889;2021;132
1956;302;55,715222;9,319221;1940;2021;81
1956;307;55,716877;9,585268;1943;2021;78
1956;315;56,552152;9,40118;1868;2021;153
1956;316;56,441433;9,422904;1951;2021;70
1956;322;54,9748134;12,2737822;1866;2021;155
1956;328;54,873518;9,518945;1921;2021;100
1956;333;57,005237;9,774809;1915;1990;75
1956;336;56,032176;10,125522;1869;2005;136
1956;346;56,067076;10,134812;1866;2021;155
1956;13;55,18902;14,96054;1867;2021;154
1956;23;55,48022;8,43888;1910;2012;102
1956;29;56,328077;10,04661;1876;2021;145
1956;115;55,88581;12,51109;1905;1958;53
1956;130;55,67057;11,18151;1899;2021;122
1956;203;55,44144;10,37108;1955;1981;26
1956;208;55,74166;11,41925;1865;2021;156
1956;219;55,66464;12,09277;1930;2001;71
1956;223;55,85422;12,46918;1950;1974;24
1956;243;55,3931;11,36045;1909;1973;64
1956;245;55,35164;11,32714;1938;2021;83
1956;300;55,77169;9,47224;1950;1960;10
1956;337;56,13962;10,20498;1928;2004;76
1957;6;55,269626;10,11524;1877;2009;132
1957;7;55,325496;10,197316;1906;1976;70
1957;19;57,141564;10,224039;1873;1974;101
1957;31;56,327986;10,048241;1955;1972;17
1957;34;55,3214857;11,9687601;1891;1987;96
1957;35;55,3225039;11,9608428;1920;2010;90
1957;38;55,973541;12,534777;1946;2021;75
1957;43;55,678145;12,54294;1957;1974;17
1957;55;55,242371;10,53961;1866;2021;155
1957;69;55,182844;9,45901;1920;2004;84
1957;73;55,84433;9,589121;1848;2021;173
1957;74;55,714019;9,683858;1930;1972;42
1957;77;56,028439;12,589834;1921;2021;100
1957;87;55,941434;12,268503;1937;2021;84
1957;88;55,944946;12,309925;1923;2021;98
1957;90;57,562284;9,986481;1891;1967;76
1957;93;57,356497;9,936222;1890;2021;131
1957;110;55,965642;9,717756;1884;2006;122
1957;131;55,46168;10,663878;1952;2005;53
1957;135;55,482156;9,451854;1949;2021;72
1957;140;55,585667;9,423096;1899;1961;62
1957;144;55,673798;12,577517;1891;2021;130
1957;145;55,682456;12,569828;1877;2021;144
1957;151;54,861238;10,73061;1867;1978;111
1957;155;56,557877;8,412895;1887;1976;89
1957;158;54,815811;11,264489;1905;1996;91
1957;165;56,6472378;9,970264;1954;2021;67
1957;168;55,51314;9,764369;1932;1978;46
1957;172;55,506291;9,750979;1955;1964;9
1957;176;55,460727;9,822756;1880;1960;80
1957;194;55,92104;10,25164;1956;2021;65
1957;195;55,9775064;10,1756177;1890;2021;131
1957;199;55,373422;10,209279;1954;1971;17
1957;205;55,790358;11,464283;1907;1972;65
1957;215;56,886164;9,836899;1886;2009;123
1957;236;56,090396;9,758625;1892;2021;129
1957;239;56,572888;9,051158;1907;2021;114
1957;256;55,070962;10,511664;1920;2021;101
1957;270;56,302138;10,477471;1894;2021;127
1957;271;54,986632;9,977204;1920;2002;82
1957;273;54,898325;9,802925;1952;2021;69
1957;294;55,471013;9,099652;1865;2021;156
1957;301;55,643464;9,651961;1889;2021;132
1957;302;55,715222;9,319221;1940;2021;81
1957;307;55,716877;9,585268;1943;2021;78
1957;315;56,552152;9,40118;1868;2021;153
1957;316;56,441433;9,422904;1951;2021;70
1957;322;54,9748134;12,2737822;1866;2021;155
1957;328;54,873518;9,518945;1921;2021;100
1957;333;57,005237;9,774809;1915;1990;75
1957;336;56,032176;10,125522;1869;2005;136
1957;346;56,067076;10,134812;1866;2021;155
1957;13;55,18902;14,96054;1867;2021;154
1957;23;55,48022;8,43888;1910;2012;102
1957;29;56,328077;10,04661;1876;2021;145
1957;115;55,88581;12,51109;1905;1958;53
1957;130;55,67057;11,18151;1899;2021;122
1957;203;55,44144;10,37108;1955;1981;26
1957;208;55,74166;11,41925;1865;2021;156
1957;219;55,66464;12,09277;1930;2001;71
1957;223;55,85422;12,46918;1950;1974;24
1957;243;55,3931;11,36045;1909;1973;64
1957;245;55,35164;11,32714;1938;2021;83
1957;300;55,77169;9,47224;1950;1960;10
1957;337;56,13962;10,20498;1928;2004;76
1958;6;55,269626;10,11524;1877;2009;132
1958;7;55,325496;10,197316;1906;1976;70
1958;19;57,141564;10,224039;1873;1974;101
1958;31;56,327986;10,048241;1955;1972;17
1958;34;55,3214857;11,9687601;1891;1987;96
1958;35;55,3225039;11,9608428;1920;2010;90
1958;38;55,973541;12,534777;1946;2021;75
1958;43;55,678145;12,54294;1957;1974;17
1958;55;55,242371;10,53961;1866;2021;155
1958;69;55,182844;9,45901;1920;2004;84
1958;73;55,84433;9,589121;1848;2021;173
1958;74;55,714019;9,683858;1930;1972;42
1958;77;56,028439;12,589834;1921;2021;100
1958;87;55,941434;12,268503;1937;2021;84
1958;88;55,944946;12,309925;1923;2021;98
1958;90;57,562284;9,986481;1891;1967;76
1958;93;57,356497;9,936222;1890;2021;131
1958;110;55,965642;9,717756;1884;2006;122
1958;131;55,46168;10,663878;1952;2005;53
1958;135;55,482156;9,451854;1949;2021;72
1958;140;55,585667;9,423096;1899;1961;62
1958;144;55,673798;12,577517;1891;2021;130
1958;145;55,682456;12,569828;1877;2021;144
1958;151;54,861238;10,73061;1867;1978;111
1958;155;56,557877;8,412895;1887;1976;89
1958;158;54,815811;11,264489;1905;1996;91
1958;165;56,6472378;9,970264;1954;2021;67
1958;168;55,51314;9,764369;1932;1978;46
1958;172;55,506291;9,750979;1955;1964;9
1958;176;55,460727;9,822756;1880;1960;80
1958;194;55,92104;10,25164;1956;2021;65
1958;195;55,9775064;10,1756177;1890;2021;131
1958;199;55,373422;10,209279;1954;1971;17
1958;205;55,790358;11,464283;1907;1972;65
1958;215;56,886164;9,836899;1886;2009;123
1958;236;56,090396;9,758625;1892;2021;129
1958;239;56,572888;9,051158;1907;2021;114
1958;256;55,070962;10,511664;1920;2021;101
1958;270;56,302138;10,477471;1894;2021;127
1958;271;54,986632;9,977204;1920;2002;82
1958;273;54,898325;9,802925;1952;2021;69
1958;294;55,471013;9,099652;1865;2021;156
1958;301;55,643464;9,651961;1889;2021;132
1958;302;55,715222;9,319221;1940;2021;81
1958;307;55,716877;9,585268;1943;2021;78
1958;315;56,552152;9,40118;1868;2021;153
1958;316;56,441433;9,422904;1951;2021;70
1958;322;54,9748134;12,2737822;1866;2021;155
1958;328;54,873518;9,518945;1921;2021;100
1958;333;57,005237;9,774809;1915;1990;75
1958;336;56,032176;10,125522;1869;2005;136
1958;346;56,067076;10,134812;1866;2021;155
1958;13;55,18902;14,96054;1867;2021;154
1958;23;55,48022;8,43888;1910;2012;102
1958;29;56,328077;10,04661;1876;2021;145
1958;114;55,88581;12,51109;1958;1976;18
1958;115;55,88581;12,51109;1905;1958;53
1958;130;55,67057;11,18151;1899;2021;122
1958;203;55,44144;10,37108;1955;1981;26
1958;208;55,74166;11,41925;1865;2021;156
1958;219;55,66464;12,09277;1930;2001;71
1958;223;55,85422;12,46918;1950;1974;24
1958;243;55,3931;11,36045;1909;1973;64
1958;245;55,35164;11,32714;1938;2021;83
1958;300;55,77169;9,47224;1950;1960;10
1958;337;56,13962;10,20498;1928;2004;76
1959;6;55,269626;10,11524;1877;2009;132
1959;7;55,325496;10,197316;1906;1976;70
1959;19;57,141564;10,224039;1873;1974;101
1959;31;56,327986;10,048241;1955;1972;17
1959;34;55,3214857;11,9687601;1891;1987;96
1959;35;55,3225039;11,9608428;1920;2010;90
1959;38;55,973541;12,534777;1946;2021;75
1959;43;55,678145;12,54294;1957;1974;17
1959;55;55,242371;10,53961;1866;2021;155
1959;69;55,182844;9,45901;1920;2004;84
1959;73;55,84433;9,589121;1848;2021;173
1959;74;55,714019;9,683858;1930;1972;42
1959;77;56,028439;12,589834;1921;2021;100
1959;87;55,941434;12,268503;1937;2021;84
1959;88;55,944946;12,309925;1923;2021;98
1959;90;57,562284;9,986481;1891;1967;76
1959;93;57,356497;9,936222;1890;2021;131
1959;110;55,965642;9,717756;1884;2006;122
1959;131;55,46168;10,663878;1952;2005;53
1959;135;55,482156;9,451854;1949;2021;72
1959;140;55,585667;9,423096;1899;1961;62
1959;144;55,673798;12,577517;1891;2021;130
1959;145;55,682456;12,569828;1877;2021;144
1959;151;54,861238;10,73061;1867;1978;111
1959;155;56,557877;8,412895;1887;1976;89
1959;158;54,815811;11,264489;1905;1996;91
1959;165;56,6472378;9,970264;1954;2021;67
1959;168;55,51314;9,764369;1932;1978;46
1959;172;55,506291;9,750979;1955;1964;9
1959;176;55,460727;9,822756;1880;1960;80
1959;194;55,92104;10,25164;1956;2021;65
1959;195;55,9775064;10,1756177;1890;2021;131
1959;199;55,373422;10,209279;1954;1971;17
1959;205;55,790358;11,464283;1907;1972;65
1959;215;56,886164;9,836899;1886;2009;123
1959;236;56,090396;9,758625;1892;2021;129
1959;239;56,572888;9,051158;1907;2021;114
1959;256;55,070962;10,511664;1920;2021;101
1959;270;56,302138;10,477471;1894;2021;127
1959;271;54,986632;9,977204;1920;2002;82
1959;273;54,898325;9,802925;1952;2021;69
1959;294;55,471013;9,099652;1865;2021;156
1959;301;55,643464;9,651961;1889;2021;132
1959;302;55,715222;9,319221;1940;2021;81
1959;307;55,716877;9,585268;1943;2021;78
1959;315;56,552152;9,40118;1868;2021;153
1959;316;56,441433;9,422904;1951;2021;70
1959;322;54,9748134;12,2737822;1866;2021;155
1959;328;54,873518;9,518945;1921;2021;100
1959;333;57,005237;9,774809;1915;1990;75
1959;336;56,032176;10,125522;1869;2005;136
1959;346;56,067076;10,134812;1866;2021;155
1959;13;55,18902;14,96054;1867;2021;154
1959;23;55,48022;8,43888;1910;2012;102
1959;29;56,328077;10,04661;1876;2021;145
1959;114;55,88581;12,51109;1958;1976;18
1959;130;55,67057;11,18151;1899;2021;122
1959;171;55,48663;9,86367;1959;2008;49
1959;203;55,44144;10,37108;1955;1981;26
1959;208;55,74166;11,41925;1865;2021;156
1959;219;55,66464;12,09277;1930;2001;71
1959;223;55,85422;12,46918;1950;1974;24
1959;243;55,3931;11,36045;1909;1973;64
1959;245;55,35164;11,32714;1938;2021;83
1959;300;55,77169;9,47224;1950;1960;10
1959;337;56,13962;10,20498;1928;2004;76
1960;6;55,269626;10,11524;1877;2009;132
1960;7;55,325496;10,197316;1906;1976;70
1960;19;57,141564;10,224039;1873;1974;101
1960;31;56,327986;10,048241;1955;1972;17
1960;34;55,3214857;11,9687601;1891;1987;96
1960;35;55,3225039;11,9608428;1920;2010;90
1960;38;55,973541;12,534777;1946;2021;75
1960;43;55,678145;12,54294;1957;1974;17
1960;55;55,242371;10,53961;1866;2021;155
1960;69;55,182844;9,45901;1920;2004;84
1960;73;55,84433;9,589121;1848;2021;173
1960;74;55,714019;9,683858;1930;1972;42
1960;77;56,028439;12,589834;1921;2021;100
1960;87;55,941434;12,268503;1937;2021;84
1960;88;55,944946;12,309925;1923;2021;98
1960;90;57,562284;9,986481;1891;1967;76
1960;93;57,356497;9,936222;1890;2021;131
1960;110;55,965642;9,717756;1884;2006;122
1960;131;55,46168;10,663878;1952;2005;53
1960;135;55,482156;9,451854;1949;2021;72
1960;140;55,585667;9,423096;1899;1961;62
1960;144;55,673798;12,577517;1891;2021;130
1960;145;55,682456;12,569828;1877;2021;144
1960;151;54,861238;10,73061;1867;1978;111
1960;155;56,557877;8,412895;1887;1976;89
1960;158;54,815811;11,264489;1905;1996;91
1960;165;56,6472378;9,970264;1954;2021;67
1960;168;55,51314;9,764369;1932;1978;46
1960;172;55,506291;9,750979;1955;1964;9
1960;176;55,460727;9,822756;1880;1960;80
1960;194;55,92104;10,25164;1956;2021;65
1960;195;55,9775064;10,1756177;1890;2021;131
1960;199;55,373422;10,209279;1954;1971;17
1960;205;55,790358;11,464283;1907;1972;65
1960;215;56,886164;9,836899;1886;2009;123
1960;236;56,090396;9,758625;1892;2021;129
1960;239;56,572888;9,051158;1907;2021;114
1960;256;55,070962;10,511664;1920;2021;101
1960;270;56,302138;10,477471;1894;2021;127
1960;271;54,986632;9,977204;1920;2002;82
1960;273;54,898325;9,802925;1952;2021;69
1960;283;55,054318;8,950471;1960;2021;61
1960;294;55,471013;9,099652;1865;2021;156
1960;301;55,643464;9,651961;1889;2021;132
1960;302;55,715222;9,319221;1940;2021;81
1960;307;55,716877;9,585268;1943;2021;78
1960;315;56,552152;9,40118;1868;2021;153
1960;316;56,441433;9,422904;1951;2021;70
1960;322;54,9748134;12,2737822;1866;2021;155
1960;328;54,873518;9,518945;1921;2021;100
1960;333;57,005237;9,774809;1915;1990;75
1960;336;56,032176;10,125522;1869;2005;136
1960;346;56,067076;10,134812;1866;2021;155
1960;13;55,18902;14,96054;1867;2021;154
1960;23;55,48022;8,43888;1910;2012;102
1960;29;56,328077;10,04661;1876;2021;145
1960;82;56,13374;9,0217;1960;2007;47
1960;114;55,88581;12,51109;1958;1976;18
1960;130;55,67057;11,18151;1899;2021;122
1960;171;55,48663;9,86367;1959;2008;49
1960;203;55,44144;10,37108;1955;1981;26
1960;208;55,74166;11,41925;1865;2021;156
1960;219;55,66464;12,09277;1930;2001;71
1960;223;55,85422;12,46918;1950;1974;24
1960;243;55,3931;11,36045;1909;1973;64
1960;245;55,35164;11,32714;1938;2021;83
1960;299;55,77169;9,47224;1960;2021;61
1960;300;55,77169;9,47224;1950;1960;10
1960;337;56,13962;10,20498;1928;2004;76
1960;347;56,09986;10,21028;1960;1978;18
1961;6;55,269626;10,11524;1877;2009;132
1961;7;55,325496;10,197316;1906;1976;70
1961;19;57,141564;10,224039;1873;1974;101
1961;31;56,327986;10,048241;1955;1972;17
1961;34;55,3214857;11,9687601;1891;1987;96
1961;35;55,3225039;11,9608428;1920;2010;90
1961;38;55,973541;12,534777;1946;2021;75
1961;43;55,678145;12,54294;1957;1974;17
1961;55;55,242371;10,53961;1866;2021;155
1961;69;55,182844;9,45901;1920;2004;84
1961;73;55,84433;9,589121;1848;2021;173
1961;74;55,714019;9,683858;1930;1972;42
1961;77;56,028439;12,589834;1921;2021;100
1961;87;55,941434;12,268503;1937;2021;84
1961;88;55,944946;12,309925;1923;2021;98
1961;90;57,562284;9,986481;1891;1967;76
1961;93;57,356497;9,936222;1890;2021;131
1961;110;55,965642;9,717756;1884;2006;122
1961;131;55,46168;10,663878;1952;2005;53
1961;135;55,482156;9,451854;1949;2021;72
1961;140;55,585667;9,423096;1899;1961;62
1961;144;55,673798;12,577517;1891;2021;130
1961;145;55,682456;12,569828;1877;2021;144
1961;151;54,861238;10,73061;1867;1978;111
1961;155;56,557877;8,412895;1887;1976;89
1961;158;54,815811;11,264489;1905;1996;91
1961;165;56,6472378;9,970264;1954;2021;67
1961;168;55,51314;9,764369;1932;1978;46
1961;172;55,506291;9,750979;1955;1964;9
1961;194;55,92104;10,25164;1956;2021;65
1961;195;55,9775064;10,1756177;1890;2021;131
1961;199;55,373422;10,209279;1954;1971;17
1961;205;55,790358;11,464283;1907;1972;65
1961;215;56,886164;9,836899;1886;2009;123
1961;236;56,090396;9,758625;1892;2021;129
1961;239;56,572888;9,051158;1907;2021;114
1961;256;55,070962;10,511664;1920;2021;101
1961;270;56,302138;10,477471;1894;2021;127
1961;271;54,986632;9,977204;1920;2002;82
1961;273;54,898325;9,802925;1952;2021;69
1961;283;55,054318;8,950471;1960;2021;61
1961;294;55,471013;9,099652;1865;2021;156
1961;301;55,643464;9,651961;1889;2021;132
1961;302;55,715222;9,319221;1940;2021;81
1961;307;55,716877;9,585268;1943;2021;78
1961;315;56,552152;9,40118;1868;2021;153
1961;316;56,441433;9,422904;1951;2021;70
1961;322;54,9748134;12,2737822;1866;2021;155
1961;328;54,873518;9,518945;1921;2021;100
1961;333;57,005237;9,774809;1915;1990;75
1961;336;56,032176;10,125522;1869;2005;136
1961;346;56,067076;10,134812;1866;2021;155
1961;13;55,18902;14,96054;1867;2021;154
1961;23;55,48022;8,43888;1910;2012;102
1961;29;56,328077;10,04661;1876;2021;145
1961;82;56,13374;9,0217;1960;2007;47
1961;114;55,88581;12,51109;1958;1976;18
1961;130;55,67057;11,18151;1899;2021;122
1961;171;55,48663;9,86367;1959;2008;49
1961;203;55,44144;10,37108;1955;1981;26
1961;208;55,74166;11,41925;1865;2021;156
1961;219;55,66464;12,09277;1930;2001;71
1961;223;55,85422;12,46918;1950;1974;24
1961;243;55,3931;11,36045;1909;1973;64
1961;245;55,35164;11,32714;1938;2021;83
1961;299;55,77169;9,47224;1960;2021;61
1961;337;56,13962;10,20498;1928;2004;76
1961;347;56,09986;10,21028;1960;1978;18
1962;6;55,269626;10,11524;1877;2009;132
1962;7;55,325496;10,197316;1906;1976;70
1962;19;57,141564;10,224039;1873;1974;101
1962;31;56,327986;10,048241;1955;1972;17
1962;34;55,3214857;11,9687601;1891;1987;96
1962;35;55,3225039;11,9608428;1920;2010;90
1962;38;55,973541;12,534777;1946;2021;75
1962;43;55,678145;12,54294;1957;1974;17
1962;55;55,242371;10,53961;1866;2021;155
1962;69;55,182844;9,45901;1920;2004;84
1962;73;55,84433;9,589121;1848;2021;173
1962;74;55,714019;9,683858;1930;1972;42
1962;77;56,028439;12,589834;1921;2021;100
1962;87;55,941434;12,268503;1937;2021;84
1962;88;55,944946;12,309925;1923;2021;98
1962;90;57,562284;9,986481;1891;1967;76
1962;93;57,356497;9,936222;1890;2021;131
1962;110;55,965642;9,717756;1884;2006;122
1962;131;55,46168;10,663878;1952;2005;53
1962;135;55,482156;9,451854;1949;2021;72
1962;144;55,673798;12,577517;1891;2021;130
1962;145;55,682456;12,569828;1877;2021;144
1962;151;54,861238;10,73061;1867;1978;111
1962;155;56,557877;8,412895;1887;1976;89
1962;158;54,815811;11,264489;1905;1996;91
1962;165;56,6472378;9,970264;1954;2021;67
1962;168;55,51314;9,764369;1932;1978;46
1962;172;55,506291;9,750979;1955;1964;9
1962;194;55,92104;10,25164;1956;2021;65
1962;195;55,9775064;10,1756177;1890;2021;131
1962;199;55,373422;10,209279;1954;1971;17
1962;205;55,790358;11,464283;1907;1972;65
1962;215;56,886164;9,836899;1886;2009;123
1962;236;56,090396;9,758625;1892;2021;129
1962;239;56,572888;9,051158;1907;2021;114
1962;256;55,070962;10,511664;1920;2021;101
1962;270;56,302138;10,477471;1894;2021;127
1962;271;54,986632;9,977204;1920;2002;82
1962;273;54,898325;9,802925;1952;2021;69
1962;283;55,054318;8,950471;1960;2021;61
1962;294;55,471013;9,099652;1865;2021;156
1962;301;55,643464;9,651961;1889;2021;132
1962;302;55,715222;9,319221;1940;2021;81
1962;307;55,716877;9,585268;1943;2021;78
1962;315;56,552152;9,40118;1868;2021;153
1962;316;56,441433;9,422904;1951;2021;70
1962;322;54,9748134;12,2737822;1866;2021;155
1962;328;54,873518;9,518945;1921;2021;100
1962;333;57,005237;9,774809;1915;1990;75
1962;336;56,032176;10,125522;1869;2005;136
1962;346;56,067076;10,134812;1866;2021;155
1962;13;55,18902;14,96054;1867;2021;154
1962;23;55,48022;8,43888;1910;2012;102
1962;29;56,328077;10,04661;1876;2021;145
1962;82;56,13374;9,0217;1960;2007;47
1962;114;55,88581;12,51109;1958;1976;18
1962;130;55,67057;11,18151;1899;2021;122
1962;171;55,48663;9,86367;1959;2008;49
1962;203;55,44144;10,37108;1955;1981;26
1962;208;55,74166;11,41925;1865;2021;156
1962;219;55,66464;12,09277;1930;2001;71
1962;223;55,85422;12,46918;1950;1974;24
1962;243;55,3931;11,36045;1909;1973;64
1962;245;55,35164;11,32714;1938;2021;83
1962;299;55,77169;9,47224;1960;2021;61
1962;337;56,13962;10,20498;1928;2004;76
1962;347;56,09986;10,21028;1960;1978;18
1963;6;55,269626;10,11524;1877;2009;132
1963;7;55,325496;10,197316;1906;1976;70
1963;19;57,141564;10,224039;1873;1974;101
1963;31;56,327986;10,048241;1955;1972;17
1963;34;55,3214857;11,9687601;1891;1987;96
1963;35;55,3225039;11,9608428;1920;2010;90
1963;38;55,973541;12,534777;1946;2021;75
1963;43;55,678145;12,54294;1957;1974;17
1963;55;55,242371;10,53961;1866;2021;155
1963;69;55,182844;9,45901;1920;2004;84
1963;73;55,84433;9,589121;1848;2021;173
1963;74;55,714019;9,683858;1930;1972;42
1963;77;56,028439;12,589834;1921;2021;100
1963;87;55,941434;12,268503;1937;2021;84
1963;88;55,944946;12,309925;1923;2021;98
1963;90;57,562284;9,986481;1891;1967;76
1963;93;57,356497;9,936222;1890;2021;131
1963;95;55,704063;11,690361;1963;2021;58
1963;110;55,965642;9,717756;1884;2006;122
1963;131;55,46168;10,663878;1952;2005;53
1963;135;55,482156;9,451854;1949;2021;72
1963;144;55,673798;12,577517;1891;2021;130
1963;145;55,682456;12,569828;1877;2021;144
1963;151;54,861238;10,73061;1867;1978;111
1963;155;56,557877;8,412895;1887;1976;89
1963;158;54,815811;11,264489;1905;1996;91
1963;165;56,6472378;9,970264;1954;2021;67
1963;168;55,51314;9,764369;1932;1978;46
1963;172;55,506291;9,750979;1955;1964;9
1963;194;55,92104;10,25164;1956;2021;65
1963;195;55,9775064;10,1756177;1890;2021;131
1963;199;55,373422;10,209279;1954;1971;17
1963;205;55,790358;11,464283;1907;1972;65
1963;215;56,886164;9,836899;1886;2009;123
1963;236;56,090396;9,758625;1892;2021;129
1963;239;56,572888;9,051158;1907;2021;114
1963;256;55,070962;10,511664;1920;2021;101
1963;270;56,302138;10,477471;1894;2021;127
1963;271;54,986632;9,977204;1920;2002;82
1963;273;54,898325;9,802925;1952;2021;69
1963;283;55,054318;8,950471;1960;2021;61
1963;294;55,471013;9,099652;1865;2021;156
1963;301;55,643464;9,651961;1889;2021;132
1963;302;55,715222;9,319221;1940;2021;81
1963;307;55,716877;9,585268;1943;2021;78
1963;315;56,552152;9,40118;1868;2021;153
1963;316;56,441433;9,422904;1951;2021;70
1963;322;54,9748134;12,2737822;1866;2021;155
1963;328;54,873518;9,518945;1921;2021;100
1963;333;57,005237;9,774809;1915;1990;75
1963;336;56,032176;10,125522;1869;2005;136
1963;346;56,067076;10,134812;1866;2021;155
1963;13;55,18902;14,96054;1867;2021;154
1963;23;55,48022;8,43888;1910;2012;102
1963;29;56,328077;10,04661;1876;2021;145
1963;82;56,13374;9,0217;1960;2007;47
1963;114;55,88581;12,51109;1958;1976;18
1963;130;55,67057;11,18151;1899;2021;122
1963;171;55,48663;9,86367;1959;2008;49
1963;203;55,44144;10,37108;1955;1981;26
1963;208;55,74166;11,41925;1865;2021;156
1963;219;55,66464;12,09277;1930;2001;71
1963;223;55,85422;12,46918;1950;1974;24
1963;243;55,3931;11,36045;1909;1973;64
1963;245;55,35164;11,32714;1938;2021;83
1963;299;55,77169;9,47224;1960;2021;61
1963;337;56,13962;10,20498;1928;2004;76
1963;347;56,09986;10,21028;1960;1978;18
1964;6;55,269626;10,11524;1877;2009;132
1964;7;55,325496;10,197316;1906;1976;70
1964;19;57,141564;10,224039;1873;1974;101
1964;31;56,327986;10,048241;1955;1972;17
1964;34;55,3214857;11,9687601;1891;1987;96
1964;35;55,3225039;11,9608428;1920;2010;90
1964;38;55,973541;12,534777;1946;2021;75
1964;43;55,678145;12,54294;1957;1974;17
1964;55;55,242371;10,53961;1866;2021;155
1964;69;55,182844;9,45901;1920;2004;84
1964;73;55,84433;9,589121;1848;2021;173
1964;74;55,714019;9,683858;1930;1972;42
1964;77;56,028439;12,589834;1921;2021;100
1964;87;55,941434;12,268503;1937;2021;84
1964;88;55,944946;12,309925;1923;2021;98
1964;90;57,562284;9,986481;1891;1967;76
1964;93;57,356497;9,936222;1890;2021;131
1964;95;55,704063;11,690361;1963;2021;58
1964;110;55,965642;9,717756;1884;2006;122
1964;131;55,46168;10,663878;1952;2005;53
1964;135;55,482156;9,451854;1949;2021;72
1964;144;55,673798;12,577517;1891;2021;130
1964;145;55,682456;12,569828;1877;2021;144
1964;151;54,861238;10,73061;1867;1978;111
1964;155;56,557877;8,412895;1887;1976;89
1964;158;54,815811;11,264489;1905;1996;91
1964;165;56,6472378;9,970264;1954;2021;67
1964;168;55,51314;9,764369;1932;1978;46
1964;172;55,506291;9,750979;1955;1964;9
1964;194;55,92104;10,25164;1956;2021;65
1964;195;55,9775064;10,1756177;1890;2021;131
1964;199;55,373422;10,209279;1954;1971;17
1964;205;55,790358;11,464283;1907;1972;65
1964;215;56,886164;9,836899;1886;2009;123
1964;236;56,090396;9,758625;1892;2021;129
1964;239;56,572888;9,051158;1907;2021;114
1964;256;55,070962;10,511664;1920;2021;101
1964;270;56,302138;10,477471;1894;2021;127
1964;271;54,986632;9,977204;1920;2002;82
1964;273;54,898325;9,802925;1952;2021;69
1964;283;55,054318;8,950471;1960;2021;61
1964;294;55,471013;9,099652;1865;2021;156
1964;301;55,643464;9,651961;1889;2021;132
1964;302;55,715222;9,319221;1940;2021;81
1964;307;55,716877;9,585268;1943;2021;78
1964;315;56,552152;9,40118;1868;2021;153
1964;316;56,441433;9,422904;1951;2021;70
1964;322;54,9748134;12,2737822;1866;2021;155
1964;328;54,873518;9,518945;1921;2021;100
1964;333;57,005237;9,774809;1915;1990;75
1964;336;56,032176;10,125522;1869;2005;136
1964;346;56,067076;10,134812;1866;2021;155
1964;13;55,18902;14,96054;1867;2021;154
1964;23;55,48022;8,43888;1910;2012;102
1964;29;56,328077;10,04661;1876;2021;145
1964;82;56,13374;9,0217;1960;2007;47
1964;114;55,88581;12,51109;1958;1976;18
1964;130;55,67057;11,18151;1899;2021;122
1964;170;55,50629;9,75098;1964;2001;37
1964;171;55,48663;9,86367;1959;2008;49
1964;203;55,44144;10,37108;1955;1981;26
1964;208;55,74166;11,41925;1865;2021;156
1964;219;55,66464;12,09277;1930;2001;71
1964;223;55,85422;12,46918;1950;1974;24
1964;243;55,3931;11,36045;1909;1973;64
1964;245;55,35164;11,32714;1938;2021;83
1964;299;55,77169;9,47224;1960;2021;61
1964;337;56,13962;10,20498;1928;2004;76
1964;347;56,09986;10,21028;1960;1978;18
1965;6;55,269626;10,11524;1877;2009;132
1965;7;55,325496;10,197316;1906;1976;70
1965;19;57,141564;10,224039;1873;1974;101
1965;31;56,327986;10,048241;1955;1972;17
1965;34;55,3214857;11,9687601;1891;1987;96
1965;35;55,3225039;11,9608428;1920;2010;90
1965;38;55,973541;12,534777;1946;2021;75
1965;43;55,678145;12,54294;1957;1974;17
1965;55;55,242371;10,53961;1866;2021;155
1965;69;55,182844;9,45901;1920;2004;84
1965;73;55,84433;9,589121;1848;2021;173
1965;74;55,714019;9,683858;1930;1972;42
1965;77;56,028439;12,589834;1921;2021;100
1965;87;55,941434;12,268503;1937;2021;84
1965;88;55,944946;12,309925;1923;2021;98
1965;90;57,562284;9,986481;1891;1967;76
1965;93;57,356497;9,936222;1890;2021;131
1965;95;55,704063;11,690361;1963;2021;58
1965;110;55,965642;9,717756;1884;2006;122
1965;131;55,46168;10,663878;1952;2005;53
1965;135;55,482156;9,451854;1949;2021;72
1965;144;55,673798;12,577517;1891;2021;130
1965;145;55,682456;12,569828;1877;2021;144
1965;151;54,861238;10,73061;1867;1978;111
1965;155;56,557877;8,412895;1887;1976;89
1965;158;54,815811;11,264489;1905;1996;91
1965;165;56,6472378;9,970264;1954;2021;67
1965;168;55,51314;9,764369;1932;1978;46
1965;194;55,92104;10,25164;1956;2021;65
1965;195;55,9775064;10,1756177;1890;2021;131
1965;199;55,373422;10,209279;1954;1971;17
1965;205;55,790358;11,464283;1907;1972;65
1965;215;56,886164;9,836899;1886;2009;123
1965;236;56,090396;9,758625;1892;2021;129
1965;239;56,572888;9,051158;1907;2021;114
1965;256;55,070962;10,511664;1920;2021;101
1965;270;56,302138;10,477471;1894;2021;127
1965;271;54,986632;9,977204;1920;2002;82
1965;273;54,898325;9,802925;1952;2021;69
1965;283;55,054318;8,950471;1960;2021;61
1965;294;55,471013;9,099652;1865;2021;156
1965;301;55,643464;9,651961;1889;2021;132
1965;302;55,715222;9,319221;1940;2021;81
1965;307;55,716877;9,585268;1943;2021;78
1965;315;56,552152;9,40118;1868;2021;153
1965;316;56,441433;9,422904;1951;2021;70
1965;322;54,9748134;12,2737822;1866;2021;155
1965;328;54,873518;9,518945;1921;2021;100
1965;333;57,005237;9,774809;1915;1990;75
1965;336;56,032176;10,125522;1869;2005;136
1965;346;56,067076;10,134812;1866;2021;155
1965;13;55,18902;14,96054;1867;2021;154
1965;23;55,48022;8,43888;1910;2012;102
1965;29;56,328077;10,04661;1876;2021;145
1965;82;56,13374;9,0217;1960;2007;47
1965;114;55,88581;12,51109;1958;1976;18
1965;130;55,67057;11,18151;1899;2021;122
1965;170;55,50629;9,75098;1964;2001;37
1965;171;55,48663;9,86367;1959;2008;49
1965;203;55,44144;10,37108;1955;1981;26
1965;208;55,74166;11,41925;1865;2021;156
1965;219;55,66464;12,09277;1930;2001;71
1965;223;55,85422;12,46918;1950;1974;24
1965;243;55,3931;11,36045;1909;1973;64
1965;245;55,35164;11,32714;1938;2021;83
1965;299;55,77169;9,47224;1960;2021;61
1965;337;56,13962;10,20498;1928;2004;76
1965;347;56,09986;10,21028;1960;1978;18
1966;6;55,269626;10,11524;1877;2009;132
1966;7;55,325496;10,197316;1906;1976;70
1966;19;57,141564;10,224039;1873;1974;101
1966;31;56,327986;10,048241;1955;1972;17
1966;34;55,3214857;11,9687601;1891;1987;96
1966;35;55,3225039;11,9608428;1920;2010;90
1966;38;55,973541;12,534777;1946;2021;75
1966;43;55,678145;12,54294;1957;1974;17
1966;55;55,242371;10,53961;1866;2021;155
1966;69;55,182844;9,45901;1920;2004;84
1966;73;55,84433;9,589121;1848;2021;173
1966;74;55,714019;9,683858;1930;1972;42
1966;77;56,028439;12,589834;1921;2021;100
1966;87;55,941434;12,268503;1937;2021;84
1966;88;55,944946;12,309925;1923;2021;98
1966;90;57,562284;9,986481;1891;1967;76
1966;93;57,356497;9,936222;1890;2021;131
1966;95;55,704063;11,690361;1963;2021;58
1966;110;55,965642;9,717756;1884;2006;122
1966;120;55,9653067;9,094499;1966;1968;2
1966;131;55,46168;10,663878;1952;2005;53
1966;135;55,482156;9,451854;1949;2021;72
1966;144;55,673798;12,577517;1891;2021;130
1966;145;55,682456;12,569828;1877;2021;144
1966;151;54,861238;10,73061;1867;1978;111
1966;155;56,557877;8,412895;1887;1976;89
1966;158;54,815811;11,264489;1905;1996;91
1966;165;56,6472378;9,970264;1954;2021;67
1966;168;55,51314;9,764369;1932;1978;46
1966;194;55,92104;10,25164;1956;2021;65
1966;195;55,9775064;10,1756177;1890;2021;131
1966;199;55,373422;10,209279;1954;1971;17
1966;205;55,790358;11,464283;1907;1972;65
1966;215;56,886164;9,836899;1886;2009;123
1966;236;56,090396;9,758625;1892;2021;129
1966;239;56,572888;9,051158;1907;2021;114
1966;256;55,070962;10,511664;1920;2021;101
1966;270;56,302138;10,477471;1894;2021;127
1966;271;54,986632;9,977204;1920;2002;82
1966;273;54,898325;9,802925;1952;2021;69
1966;283;55,054318;8,950471;1960;2021;61
1966;294;55,471013;9,099652;1865;2021;156
1966;301;55,643464;9,651961;1889;2021;132
1966;302;55,715222;9,319221;1940;2021;81
1966;307;55,716877;9,585268;1943;2021;78
1966;315;56,552152;9,40118;1868;2021;153
1966;316;56,441433;9,422904;1951;2021;70
1966;322;54,9748134;12,2737822;1866;2021;155
1966;328;54,873518;9,518945;1921;2021;100
1966;333;57,005237;9,774809;1915;1990;75
1966;336;56,032176;10,125522;1869;2005;136
1966;346;56,067076;10,134812;1866;2021;155
1966;13;55,18902;14,96054;1867;2021;154
1966;23;55,48022;8,43888;1910;2012;102
1966;29;56,328077;10,04661;1876;2021;145
1966;82;56,13374;9,0217;1960;2007;47
1966;114;55,88581;12,51109;1958;1976;18
1966;130;55,67057;11,18151;1899;2021;122
1966;170;55,50629;9,75098;1964;2001;37
1966;171;55,48663;9,86367;1959;2008;49
1966;203;55,44144;10,37108;1955;1981;26
1966;208;55,74166;11,41925;1865;2021;156
1966;219;55,66464;12,09277;1930;2001;71
1966;223;55,85422;12,46918;1950;1974;24
1966;243;55,3931;11,36045;1909;1973;64
1966;245;55,35164;11,32714;1938;2021;83
1966;299;55,77169;9,47224;1960;2021;61
1966;337;56,13962;10,20498;1928;2004;76
1966;347;56,09986;10,21028;1960;1978;18
1967;6;55,269626;10,11524;1877;2009;132
1967;7;55,325496;10,197316;1906;1976;70
1967;19;57,141564;10,224039;1873;1974;101
1967;31;56,327986;10,048241;1955;1972;17
1967;34;55,3214857;11,9687601;1891;1987;96
1967;35;55,3225039;11,9608428;1920;2010;90
1967;38;55,973541;12,534777;1946;2021;75
1967;43;55,678145;12,54294;1957;1974;17
1967;55;55,242371;10,53961;1866;2021;155
1967;69;55,182844;9,45901;1920;2004;84
1967;73;55,84433;9,589121;1848;2021;173
1967;74;55,714019;9,683858;1930;1972;42
1967;77;56,028439;12,589834;1921;2021;100
1967;87;55,941434;12,268503;1937;2021;84
1967;88;55,944946;12,309925;1923;2021;98
1967;90;57,562284;9,986481;1891;1967;76
1967;93;57,356497;9,936222;1890;2021;131
1967;95;55,704063;11,690361;1963;2021;58
1967;110;55,965642;9,717756;1884;2006;122
1967;120;55,9653067;9,094499;1966;1968;2
1967;131;55,46168;10,663878;1952;2005;53
1967;135;55,482156;9,451854;1949;2021;72
1967;144;55,673798;12,577517;1891;2021;130
1967;145;55,682456;12,569828;1877;2021;144
1967;151;54,861238;10,73061;1867;1978;111
1967;155;56,557877;8,412895;1887;1976;89
1967;158;54,815811;11,264489;1905;1996;91
1967;165;56,6472378;9,970264;1954;2021;67
1967;168;55,51314;9,764369;1932;1978;46
1967;194;55,92104;10,25164;1956;2021;65
1967;195;55,9775064;10,1756177;1890;2021;131
1967;199;55,373422;10,209279;1954;1971;17
1967;205;55,790358;11,464283;1907;1972;65
1967;215;56,886164;9,836899;1886;2009;123
1967;236;56,090396;9,758625;1892;2021;129
1967;239;56,572888;9,051158;1907;2021;114
1967;256;55,070962;10,511664;1920;2021;101
1967;270;56,302138;10,477471;1894;2021;127
1967;271;54,986632;9,977204;1920;2002;82
1967;273;54,898325;9,802925;1952;2021;69
1967;283;55,054318;8,950471;1960;2021;61
1967;294;55,471013;9,099652;1865;2021;156
1967;301;55,643464;9,651961;1889;2021;132
1967;302;55,715222;9,319221;1940;2021;81
1967;307;55,716877;9,585268;1943;2021;78
1967;315;56,552152;9,40118;1868;2021;153
1967;316;56,441433;9,422904;1951;2021;70
1967;322;54,9748134;12,2737822;1866;2021;155
1967;328;54,873518;9,518945;1921;2021;100
1967;333;57,005237;9,774809;1915;1990;75
1967;336;56,032176;10,125522;1869;2005;136
1967;346;56,067076;10,134812;1866;2021;155
1967;13;55,18902;14,96054;1867;2021;154
1967;23;55,48022;8,43888;1910;2012;102
1967;29;56,328077;10,04661;1876;2021;145
1967;82;56,13374;9,0217;1960;2007;47
1967;114;55,88581;12,51109;1958;1976;18
1967;130;55,67057;11,18151;1899;2021;122
1967;170;55,50629;9,75098;1964;2001;37
1967;171;55,48663;9,86367;1959;2008;49
1967;203;55,44144;10,37108;1955;1981;26
1967;208;55,74166;11,41925;1865;2021;156
1967;219;55,66464;12,09277;1930;2001;71
1967;223;55,85422;12,46918;1950;1974;24
1967;243;55,3931;11,36045;1909;1973;64
1967;245;55,35164;11,32714;1938;2021;83
1967;299;55,77169;9,47224;1960;2021;61
1967;337;56,13962;10,20498;1928;2004;76
1967;347;56,09986;10,21028;1960;1978;18
1968;6;55,269626;10,11524;1877;2009;132
1968;7;55,325496;10,197316;1906;1976;70
1968;19;57,141564;10,224039;1873;1974;101
1968;31;56,327986;10,048241;1955;1972;17
1968;34;55,3214857;11,9687601;1891;1987;96
1968;35;55,3225039;11,9608428;1920;2010;90
1968;38;55,973541;12,534777;1946;2021;75
1968;43;55,678145;12,54294;1957;1974;17
1968;55;55,242371;10,53961;1866;2021;155
1968;69;55,182844;9,45901;1920;2004;84
1968;73;55,84433;9,589121;1848;2021;173
1968;74;55,714019;9,683858;1930;1972;42
1968;77;56,028439;12,589834;1921;2021;100
1968;87;55,941434;12,268503;1937;2021;84
1968;88;55,944946;12,309925;1923;2021;98
1968;93;57,356497;9,936222;1890;2021;131
1968;95;55,704063;11,690361;1963;2021;58
1968;110;55,965642;9,717756;1884;2006;122
1968;120;55,9653067;9,094499;1966;1968;2
1968;131;55,46168;10,663878;1952;2005;53
1968;135;55,482156;9,451854;1949;2021;72
1968;144;55,673798;12,577517;1891;2021;130
1968;145;55,682456;12,569828;1877;2021;144
1968;151;54,861238;10,73061;1867;1978;111
1968;155;56,557877;8,412895;1887;1976;89
1968;158;54,815811;11,264489;1905;1996;91
1968;165;56,6472378;9,970264;1954;2021;67
1968;168;55,51314;9,764369;1932;1978;46
1968;194;55,92104;10,25164;1956;2021;65
1968;195;55,9775064;10,1756177;1890;2021;131
1968;199;55,373422;10,209279;1954;1971;17
1968;205;55,790358;11,464283;1907;1972;65
1968;215;56,886164;9,836899;1886;2009;123
1968;236;56,090396;9,758625;1892;2021;129
1968;239;56,572888;9,051158;1907;2021;114
1968;256;55,070962;10,511664;1920;2021;101
1968;270;56,302138;10,477471;1894;2021;127
1968;271;54,986632;9,977204;1920;2002;82
1968;273;54,898325;9,802925;1952;2021;69
1968;283;55,054318;8,950471;1960;2021;61
1968;294;55,471013;9,099652;1865;2021;156
1968;301;55,643464;9,651961;1889;2021;132
1968;302;55,715222;9,319221;1940;2021;81
1968;307;55,716877;9,585268;1943;2021;78
1968;315;56,552152;9,40118;1868;2021;153
1968;316;56,441433;9,422904;1951;2021;70
1968;322;54,9748134;12,2737822;1866;2021;155
1968;328;54,873518;9,518945;1921;2021;100
1968;333;57,005237;9,774809;1915;1990;75
1968;336;56,032176;10,125522;1869;2005;136
1968;346;56,067076;10,134812;1866;2021;155
1968;13;55,18902;14,96054;1867;2021;154
1968;23;55,48022;8,43888;1910;2012;102
1968;29;56,328077;10,04661;1876;2021;145
1968;82;56,13374;9,0217;1960;2007;47
1968;114;55,88581;12,51109;1958;1976;18
1968;130;55,67057;11,18151;1899;2021;122
1968;170;55,50629;9,75098;1964;2001;37
1968;171;55,48663;9,86367;1959;2008;49
1968;203;55,44144;10,37108;1955;1981;26
1968;208;55,74166;11,41925;1865;2021;156
1968;219;55,66464;12,09277;1930;2001;71
1968;223;55,85422;12,46918;1950;1974;24
1968;243;55,3931;11,36045;1909;1973;64
1968;245;55,35164;11,32714;1938;2021;83
1968;299;55,77169;9,47224;1960;2021;61
1968;337;56,13962;10,20498;1928;2004;76
1968;347;56,09986;10,21028;1960;1978;18
1969;6;55,269626;10,11524;1877;2009;132
1969;7;55,325496;10,197316;1906;1976;70
1969;19;57,141564;10,224039;1873;1974;101
1969;31;56,327986;10,048241;1955;1972;17
1969;34;55,3214857;11,9687601;1891;1987;96
1969;35;55,3225039;11,9608428;1920;2010;90
1969;38;55,973541;12,534777;1946;2021;75
1969;43;55,678145;12,54294;1957;1974;17
1969;55;55,242371;10,53961;1866;2021;155
1969;69;55,182844;9,45901;1920;2004;84
1969;73;55,84433;9,589121;1848;2021;173
1969;74;55,714019;9,683858;1930;1972;42
1969;77;56,028439;12,589834;1921;2021;100
1969;79;56,051014;12,584655;1969;2008;39
1969;87;55,941434;12,268503;1937;2021;84
1969;88;55,944946;12,309925;1923;2021;98
1969;93;57,356497;9,936222;1890;2021;131
1969;95;55,704063;11,690361;1963;2021;58
1969;110;55,965642;9,717756;1884;2006;122
1969;131;55,46168;10,663878;1952;2005;53
1969;135;55,482156;9,451854;1949;2021;72
1969;144;55,673798;12,577517;1891;2021;130
1969;145;55,682456;12,569828;1877;2021;144
1969;151;54,861238;10,73061;1867;1978;111
1969;155;56,557877;8,412895;1887;1976;89
1969;158;54,815811;11,264489;1905;1996;91
1969;165;56,6472378;9,970264;1954;2021;67
1969;168;55,51314;9,764369;1932;1978;46
1969;194;55,92104;10,25164;1956;2021;65
1969;195;55,9775064;10,1756177;1890;2021;131
1969;199;55,373422;10,209279;1954;1971;17
1969;205;55,790358;11,464283;1907;1972;65
1969;215;56,886164;9,836899;1886;2009;123
1969;217;56,06639;8,314841;1969;2021;52
1969;236;56,090396;9,758625;1892;2021;129
1969;239;56,572888;9,051158;1907;2021;114
1969;256;55,070962;10,511664;1920;2021;101
1969;270;56,302138;10,477471;1894;2021;127
1969;271;54,986632;9,977204;1920;2002;82
1969;273;54,898325;9,802925;1952;2021;69
1969;283;55,054318;8,950471;1960;2021;61
1969;294;55,471013;9,099652;1865;2021;156
1969;301;55,643464;9,651961;1889;2021;132
1969;302;55,715222;9,319221;1940;2021;81
1969;307;55,716877;9,585268;1943;2021;78
1969;315;56,552152;9,40118;1868;2021;153
1969;316;56,441433;9,422904;1951;2021;70
1969;322;54,9748134;12,2737822;1866;2021;155
1969;328;54,873518;9,518945;1921;2021;100
1969;333;57,005237;9,774809;1915;1990;75
1969;336;56,032176;10,125522;1869;2005;136
1969;346;56,067076;10,134812;1866;2021;155
1969;13;55,18902;14,96054;1867;2021;154
1969;23;55,48022;8,43888;1910;2012;102
1969;29;56,328077;10,04661;1876;2021;145
1969;82;56,13374;9,0217;1960;2007;47
1969;114;55,88581;12,51109;1958;1976;18
1969;130;55,67057;11,18151;1899;2021;122
1969;170;55,50629;9,75098;1964;2001;37
1969;171;55,48663;9,86367;1959;2008;49
1969;203;55,44144;10,37108;1955;1981;26
1969;208;55,74166;11,41925;1865;2021;156
1969;219;55,66464;12,09277;1930;2001;71
1969;223;55,85422;12,46918;1950;1974;24
1969;243;55,3931;11,36045;1909;1973;64
1969;245;55,35164;11,32714;1938;2021;83
1969;299;55,77169;9,47224;1960;2021;61
1969;337;56,13962;10,20498;1928;2004;76
1969;347;56,09986;10,21028;1960;1978;18
1970;3;55,412663;10,12987;1970;2011;41
1970;6;55,269626;10,11524;1877;2009;132
1970;7;55,325496;10,197316;1906;1976;70
1970;19;57,141564;10,224039;1873;1974;101
1970;27;55,434525;8,367173;1970;1971;1
1970;31;56,327986;10,048241;1955;1972;17
1970;34;55,3214857;11,9687601;1891;1987;96
1970;35;55,3225039;11,9608428;1920;2010;90
1970;38;55,973541;12,534777;1946;2021;75
1970;43;55,678145;12,54294;1957;1974;17
1970;55;55,242371;10,53961;1866;2021;155
1970;69;55,182844;9,45901;1920;2004;84
1970;73;55,84433;9,589121;1848;2021;173
1970;74;55,714019;9,683858;1930;1972;42
1970;77;56,028439;12,589834;1921;2021;100
1970;79;56,051014;12,584655;1969;2008;39
1970;87;55,941434;12,268503;1937;2021;84
1970;88;55,944946;12,309925;1923;2021;98
1970;93;57,356497;9,936222;1890;2021;131
1970;95;55,704063;11,690361;1963;2021;58
1970;110;55,965642;9,717756;1884;2006;122
1970;131;55,46168;10,663878;1952;2005;53
1970;135;55,482156;9,451854;1949;2021;72
1970;144;55,673798;12,577517;1891;2021;130
1970;145;55,682456;12,569828;1877;2021;144
1970;151;54,861238;10,73061;1867;1978;111
1970;155;56,557877;8,412895;1887;1976;89
1970;158;54,815811;11,264489;1905;1996;91
1970;165;56,6472378;9,970264;1954;2021;67
1970;168;55,51314;9,764369;1932;1978;46
1970;194;55,92104;10,25164;1956;2021;65
1970;195;55,9775064;10,1756177;1890;2021;131
1970;199;55,373422;10,209279;1954;1971;17
1970;205;55,790358;11,464283;1907;1972;65
1970;215;56,886164;9,836899;1886;2009;123
1970;217;56,06639;8,314841;1969;2021;52
1970;236;56,090396;9,758625;1892;2021;129
1970;239;56,572888;9,051158;1907;2021;114
1970;256;55,070962;10,511664;1920;2021;101
1970;270;56,302138;10,477471;1894;2021;127
1970;271;54,986632;9,977204;1920;2002;82
1970;273;54,898325;9,802925;1952;2021;69
1970;283;55,054318;8,950471;1960;2021;61
1970;294;55,471013;9,099652;1865;2021;156
1970;301;55,643464;9,651961;1889;2021;132
1970;302;55,715222;9,319221;1940;2021;81
1970;307;55,716877;9,585268;1943;2021;78
1970;315;56,552152;9,40118;1868;2021;153
1970;316;56,441433;9,422904;1951;2021;70
1970;322;54,9748134;12,2737822;1866;2021;155
1970;328;54,873518;9,518945;1921;2021;100
1970;333;57,005237;9,774809;1915;1990;75
1970;336;56,032176;10,125522;1869;2005;136
1970;339;56,214752;10,27358;1970;2021;51
1970;342;56,1956788;10,2204946;1970;2021;51
1970;346;56,067076;10,134812;1866;2021;155
1970;13;55,18902;14,96054;1867;2021;154
1970;23;55,48022;8,43888;1910;2012;102
1970;26;55,28979;8,68128;1970;2021;51
1970;29;56,328077;10,04661;1876;2021;145
1970;82;56,13374;9,0217;1960;2007;47
1970;114;55,88581;12,51109;1958;1976;18
1970;130;55,67057;11,18151;1899;2021;122
1970;170;55,50629;9,75098;1964;2001;37
1970;171;55,48663;9,86367;1959;2008;49
1970;203;55,44144;10,37108;1955;1981;26
1970;208;55,74166;11,41925;1865;2021;156
1970;219;55,66464;12,09277;1930;2001;71
1970;223;55,85422;12,46918;1950;1974;24
1970;243;55,3931;11,36045;1909;1973;64
1970;245;55,35164;11,32714;1938;2021;83
1970;292;55,62655;8,27648;1970;1973;3
1970;299;55,77169;9,47224;1960;2021;61
1970;337;56,13962;10,20498;1928;2004;76
1970;347;56,09986;10,21028;1960;1978;18
1971;3;55,412663;10,12987;1970;2011;41
1971;6;55,269626;10,11524;1877;2009;132
1971;7;55,325496;10,197316;1906;1976;70
1971;19;57,141564;10,224039;1873;1974;101
1971;27;55,434525;8,367173;1970;1971;1
1971;31;56,327986;10,048241;1955;1972;17
1971;34;55,3214857;11,9687601;1891;1987;96
1971;35;55,3225039;11,9608428;1920;2010;90
1971;38;55,973541;12,534777;1946;2021;75
1971;43;55,678145;12,54294;1957;1974;17
1971;55;55,242371;10,53961;1866;2021;155
1971;64;54,689732;11,964726;1971;2021;50
1971;69;55,182844;9,45901;1920;2004;84
1971;73;55,84433;9,589121;1848;2021;173
1971;74;55,714019;9,683858;1930;1972;42
1971;77;56,028439;12,589834;1921;2021;100
1971;79;56,051014;12,584655;1969;2008;39
1971;87;55,941434;12,268503;1937;2021;84
1971;88;55,944946;12,309925;1923;2021;98
1971;93;57,356497;9,936222;1890;2021;131
1971;95;55,704063;11,690361;1963;2021;58
1971;101;56,257646;8,279111;1971;1996;25
1971;110;55,965642;9,717756;1884;2006;122
1971;131;55,46168;10,663878;1952;2005;53
1971;135;55,482156;9,451854;1949;2021;72
1971;144;55,673798;12,577517;1891;2021;130
1971;145;55,682456;12,569828;1877;2021;144
1971;151;54,861238;10,73061;1867;1978;111
1971;155;56,557877;8,412895;1887;1976;89
1971;156;56,546487;8,414392;1971;2021;50
1971;158;54,815811;11,264489;1905;1996;91
1971;165;56,6472378;9,970264;1954;2021;67
1971;168;55,51314;9,764369;1932;1978;46
1971;194;55,92104;10,25164;1956;2021;65
1971;195;55,9775064;10,1756177;1890;2021;131
1971;199;55,373422;10,209279;1954;1971;17
1971;205;55,790358;11,464283;1907;1972;65
1971;215;56,886164;9,836899;1886;2009;123
1971;217;56,06639;8,314841;1969;2021;52
1971;230;56,178325;9,590822;1971;2021;50
1971;236;56,090396;9,758625;1892;2021;129
1971;239;56,572888;9,051158;1907;2021;114
1971;256;55,070962;10,511664;1920;2021;101
1971;270;56,302138;10,477471;1894;2021;127
1971;271;54,986632;9,977204;1920;2002;82
1971;273;54,898325;9,802925;1952;2021;69
1971;283;55,054318;8,950471;1960;2021;61
1971;294;55,471013;9,099652;1865;2021;156
1971;301;55,643464;9,651961;1889;2021;132
1971;302;55,715222;9,319221;1940;2021;81
1971;307;55,716877;9,585268;1943;2021;78
1971;315;56,552152;9,40118;1868;2021;153
1971;316;56,441433;9,422904;1951;2021;70
1971;322;54,9748134;12,2737822;1866;2021;155
1971;328;54,873518;9,518945;1921;2021;100
1971;333;57,005237;9,774809;1915;1990;75
1971;336;56,032176;10,125522;1869;2005;136
1971;339;56,214752;10,27358;1970;2021;51
1971;342;56,1956788;10,2204946;1970;2021;51
1971;343;56,101781;10,070482;1971;2011;40
1971;346;56,067076;10,134812;1866;2021;155
1971;13;55,18902;14,96054;1867;2021;154
1971;23;55,48022;8,43888;1910;2012;102
1971;26;55,28979;8,68128;1970;2021;51
1971;29;56,328077;10,04661;1876;2021;145
1971;82;56,13374;9,0217;1960;2007;47
1971;114;55,88581;12,51109;1958;1976;18
1971;130;55,67057;11,18151;1899;2021;122
1971;170;55,50629;9,75098;1964;2001;37
1971;171;55,48663;9,86367;1959;2008;49
1971;203;55,44144;10,37108;1955;1981;26
1971;208;55,74166;11,41925;1865;2021;156
1971;219;55,66464;12,09277;1930;2001;71
1971;222;55,81254;12,49478;1971;1973;2
1971;223;55,85422;12,46918;1950;1974;24
1971;243;55,3931;11,36045;1909;1973;64
1971;245;55,35164;11,32714;1938;2021;83
1971;292;55,62655;8,27648;1970;1973;3
1971;299;55,77169;9,47224;1960;2021;61
1971;337;56,13962;10,20498;1928;2004;76
1971;347;56,09986;10,21028;1960;1978;18
1972;3;55,412663;10,12987;1970;2011;41
1972;6;55,269626;10,11524;1877;2009;132
1972;7;55,325496;10,197316;1906;1976;70
1972;19;57,141564;10,224039;1873;1974;101
1972;31;56,327986;10,048241;1955;1972;17
1972;34;55,3214857;11,9687601;1891;1987;96
1972;35;55,3225039;11,9608428;1920;2010;90
1972;38;55,973541;12,534777;1946;2021;75
1972;43;55,678145;12,54294;1957;1974;17
1972;55;55,242371;10,53961;1866;2021;155
1972;64;54,689732;11,964726;1971;2021;50
1972;69;55,182844;9,45901;1920;2004;84
1972;73;55,84433;9,589121;1848;2021;173
1972;74;55,714019;9,683858;1930;1972;42
1972;77;56,028439;12,589834;1921;2021;100
1972;79;56,051014;12,584655;1969;2008;39
1972;87;55,941434;12,268503;1937;2021;84
1972;88;55,944946;12,309925;1923;2021;98
1972;93;57,356497;9,936222;1890;2021;131
1972;95;55,704063;11,690361;1963;2021;58
1972;101;56,257646;8,279111;1971;1996;25
1972;110;55,965642;9,717756;1884;2006;122
1972;131;55,46168;10,663878;1952;2005;53
1972;135;55,482156;9,451854;1949;2021;72
1972;144;55,673798;12,577517;1891;2021;130
1972;145;55,682456;12,569828;1877;2021;144
1972;151;54,861238;10,73061;1867;1978;111
1972;155;56,557877;8,412895;1887;1976;89
1972;156;56,546487;8,414392;1971;2021;50
1972;158;54,815811;11,264489;1905;1996;91
1972;165;56,6472378;9,970264;1954;2021;67
1972;168;55,51314;9,764369;1932;1978;46
1972;194;55,92104;10,25164;1956;2021;65
1972;195;55,9775064;10,1756177;1890;2021;131
1972;196;55,991623;10,251408;1972;2015;43
1972;205;55,790358;11,464283;1907;1972;65
1972;215;56,886164;9,836899;1886;2009;123
1972;217;56,06639;8,314841;1969;2021;52
1972;230;56,178325;9,590822;1971;2021;50
1972;236;56,090396;9,758625;1892;2021;129
1972;239;56,572888;9,051158;1907;2021;114
1972;255;55,058636;10,606186;1972;1997;25
1972;256;55,070962;10,511664;1920;2021;101
1972;270;56,302138;10,477471;1894;2021;127
1972;271;54,986632;9,977204;1920;2002;82
1972;273;54,898325;9,802925;1952;2021;69
1972;283;55,054318;8,950471;1960;2021;61
1972;294;55,471013;9,099652;1865;2021;156
1972;301;55,643464;9,651961;1889;2021;132
1972;302;55,715222;9,319221;1940;2021;81
1972;307;55,716877;9,585268;1943;2021;78
1972;314;56,377182;9,64424;1972;2021;49
1972;315;56,552152;9,40118;1868;2021;153
1972;316;56,441433;9,422904;1951;2021;70
1972;322;54,9748134;12,2737822;1866;2021;155
1972;328;54,873518;9,518945;1921;2021;100
1972;333;57,005237;9,774809;1915;1990;75
1972;336;56,032176;10,125522;1869;2005;136
1972;339;56,214752;10,27358;1970;2021;51
1972;342;56,1956788;10,2204946;1970;2021;51
1972;343;56,101781;10,070482;1971;2011;40
1972;346;56,067076;10,134812;1866;2021;155
1972;13;55,18902;14,96054;1867;2021;154
1972;23;55,48022;8,43888;1910;2012;102
1972;26;55,28979;8,68128;1970;2021;51
1972;29;56,328077;10,04661;1876;2021;145
1972;82;56,13374;9,0217;1960;2007;47
1972;83;56,08339;8,98743;1972;2021;49
1972;114;55,88581;12,51109;1958;1976;18
1972;130;55,67057;11,18151;1899;2021;122
1972;136;55,50785;9,47085;1972;1998;26
1972;170;55,50629;9,75098;1964;2001;37
1972;171;55,48663;9,86367;1959;2008;49
1972;203;55,44144;10,37108;1955;1981;26
1972;208;55,74166;11,41925;1865;2021;156
1972;219;55,66464;12,09277;1930;2001;71
1972;222;55,81254;12,49478;1971;1973;2
1972;223;55,85422;12,46918;1950;1974;24
1972;243;55,3931;11,36045;1909;1973;64
1972;245;55,35164;11,32714;1938;2021;83
1972;277;56,85548;8,61062;1972;1974;2
1972;292;55,62655;8,27648;1970;1973;3
1972;299;55,77169;9,47224;1960;2021;61
1972;337;56,13962;10,20498;1928;2004;76
1972;347;56,09986;10,21028;1960;1978;18
1973;3;55,412663;10,12987;1970;2011;41
1973;6;55,269626;10,11524;1877;2009;132
1973;7;55,325496;10,197316;1906;1976;70
1973;19;57,141564;10,224039;1873;1974;101
1973;34;55,3214857;11,9687601;1891;1987;96
1973;35;55,3225039;11,9608428;1920;2010;90
1973;38;55,973541;12,534777;1946;2021;75
1973;43;55,678145;12,54294;1957;1974;17
1973;55;55,242371;10,53961;1866;2021;155
1973;64;54,689732;11,964726;1971;2021;50
1973;69;55,182844;9,45901;1920;2004;84
1973;73;55,84433;9,589121;1848;2021;173
1973;77;56,028439;12,589834;1921;2021;100
1973;79;56,051014;12,584655;1969;2008;39
1973;87;55,941434;12,268503;1937;2021;84
1973;88;55,944946;12,309925;1923;2021;98
1973;93;57,356497;9,936222;1890;2021;131
1973;95;55,704063;11,690361;1963;2021;58
1973;101;56,257646;8,279111;1971;1996;25
1973;102;56,359714;8,597986;1973;2004;31
1973;110;55,965642;9,717756;1884;2006;122
1973;131;55,46168;10,663878;1952;2005;53
1973;135;55,482156;9,451854;1949;2021;72
1973;144;55,673798;12,577517;1891;2021;130
1973;145;55,682456;12,569828;1877;2021;144
1973;151;54,861238;10,73061;1867;1978;111
1973;155;56,557877;8,412895;1887;1976;89
1973;156;56,546487;8,414392;1971;2021;50
1973;158;54,815811;11,264489;1905;1996;91
1973;165;56,6472378;9,970264;1954;2021;67
1973;168;55,51314;9,764369;1932;1978;46
1973;194;55,92104;10,25164;1956;2021;65
1973;195;55,9775064;10,1756177;1890;2021;131
1973;196;55,991623;10,251408;1972;2015;43
1973;215;56,886164;9,836899;1886;2009;123
1973;217;56,06639;8,314841;1969;2021;52
1973;230;56,178325;9,590822;1971;2021;50
1973;236;56,090396;9,758625;1892;2021;129
1973;239;56,572888;9,051158;1907;2021;114
1973;248;55,2506641;11,274915;1973;2005;32
1973;255;55,058636;10,606186;1972;1997;25
1973;256;55,070962;10,511664;1920;2021;101
1973;270;56,302138;10,477471;1894;2021;127
1973;271;54,986632;9,977204;1920;2002;82
1973;273;54,898325;9,802925;1952;2021;69
1973;283;55,054318;8,950471;1960;2021;61
1973;294;55,471013;9,099652;1865;2021;156
1973;301;55,643464;9,651961;1889;2021;132
1973;302;55,715222;9,319221;1940;2021;81
1973;307;55,716877;9,585268;1943;2021;78
1973;314;56,377182;9,64424;1972;2021;49
1973;315;56,552152;9,40118;1868;2021;153
1973;316;56,441433;9,422904;1951;2021;70
1973;322;54,9748134;12,2737822;1866;2021;155
1973;328;54,873518;9,518945;1921;2021;100
1973;333;57,005237;9,774809;1915;1990;75
1973;336;56,032176;10,125522;1869;2005;136
1973;339;56,214752;10,27358;1970;2021;51
1973;342;56,1956788;10,2204946;1970;2021;51
1973;343;56,101781;10,070482;1971;2011;40
1973;346;56,067076;10,134812;1866;2021;155
1973;13;55,18902;14,96054;1867;2021;154
1973;23;55,48022;8,43888;1910;2012;102
1973;26;55,28979;8,68128;1970;2021;51
1973;29;56,328077;10,04661;1876;2021;145
1973;82;56,13374;9,0217;1960;2007;47
1973;83;56,08339;8,98743;1972;2021;49
1973;114;55,88581;12,51109;1958;1976;18
1973;130;55,67057;11,18151;1899;2021;122
1973;136;55,50785;9,47085;1972;1998;26
1973;170;55,50629;9,75098;1964;2001;37
1973;171;55,48663;9,86367;1959;2008;49
1973;203;55,44144;10,37108;1955;1981;26
1973;208;55,74166;11,41925;1865;2021;156
1973;219;55,66464;12,09277;1930;2001;71
1973;222;55,81254;12,49478;1971;1973;2
1973;223;55,85422;12,46918;1950;1974;24
1973;243;55,3931;11,36045;1909;1973;64
1973;245;55,35164;11,32714;1938;2021;83
1973;277;56,85548;8,61062;1972;1974;2
1973;292;55,62655;8,27648;1970;1973;3
1973;299;55,77169;9,47224;1960;2021;61
1973;337;56,13962;10,20498;1928;2004;76
1973;347;56,09986;10,21028;1960;1978;18
1974;3;55,412663;10,12987;1970;2011;41
1974;6;55,269626;10,11524;1877;2009;132
1974;7;55,325496;10,197316;1906;1976;70
1974;19;57,141564;10,224039;1873;1974;101
1974;34;55,3214857;11,9687601;1891;1987;96
1974;35;55,3225039;11,9608428;1920;2010;90
1974;38;55,973541;12,534777;1946;2021;75
1974;43;55,678145;12,54294;1957;1974;17
1974;55;55,242371;10,53961;1866;2021;155
1974;64;54,689732;11,964726;1971;2021;50
1974;69;55,182844;9,45901;1920;2004;84
1974;73;55,84433;9,589121;1848;2021;173
1974;77;56,028439;12,589834;1921;2021;100
1974;79;56,051014;12,584655;1969;2008;39
1974;87;55,941434;12,268503;1937;2021;84
1974;88;55,944946;12,309925;1923;2021;98
1974;93;57,356497;9,936222;1890;2021;131
1974;95;55,704063;11,690361;1963;2021;58
1974;101;56,257646;8,279111;1971;1996;25
1974;102;56,359714;8,597986;1973;2004;31
1974;110;55,965642;9,717756;1884;2006;122
1974;131;55,46168;10,663878;1952;2005;53
1974;135;55,482156;9,451854;1949;2021;72
1974;144;55,673798;12,577517;1891;2021;130
1974;145;55,682456;12,569828;1877;2021;144
1974;151;54,861238;10,73061;1867;1978;111
1974;155;56,557877;8,412895;1887;1976;89
1974;156;56,546487;8,414392;1971;2021;50
1974;158;54,815811;11,264489;1905;1996;91
1974;165;56,6472378;9,970264;1954;2021;67
1974;168;55,51314;9,764369;1932;1978;46
1974;194;55,92104;10,25164;1956;2021;65
1974;195;55,9775064;10,1756177;1890;2021;131
1974;196;55,991623;10,251408;1972;2015;43
1974;215;56,886164;9,836899;1886;2009;123
1974;217;56,06639;8,314841;1969;2021;52
1974;230;56,178325;9,590822;1971;2021;50
1974;236;56,090396;9,758625;1892;2021;129
1974;239;56,572888;9,051158;1907;2021;114
1974;248;55,2506641;11,274915;1973;2005;32
1974;255;55,058636;10,606186;1972;1997;25
1974;256;55,070962;10,511664;1920;2021;101
1974;270;56,302138;10,477471;1894;2021;127
1974;271;54,986632;9,977204;1920;2002;82
1974;273;54,898325;9,802925;1952;2021;69
1974;283;55,054318;8,950471;1960;2021;61
1974;294;55,471013;9,099652;1865;2021;156
1974;301;55,643464;9,651961;1889;2021;132
1974;302;55,715222;9,319221;1940;2021;81
1974;307;55,716877;9,585268;1943;2021;78
1974;314;56,377182;9,64424;1972;2021;49
1974;315;56,552152;9,40118;1868;2021;153
1974;316;56,441433;9,422904;1951;2021;70
1974;322;54,9748134;12,2737822;1866;2021;155
1974;328;54,873518;9,518945;1921;2021;100
1974;333;57,005237;9,774809;1915;1990;75
1974;336;56,032176;10,125522;1869;2005;136
1974;339;56,214752;10,27358;1970;2021;51
1974;342;56,1956788;10,2204946;1970;2021;51
1974;343;56,101781;10,070482;1971;2011;40
1974;346;56,067076;10,134812;1866;2021;155
1974;13;55,18902;14,96054;1867;2021;154
1974;23;55,48022;8,43888;1910;2012;102
1974;26;55,28979;8,68128;1970;2021;51
1974;29;56,328077;10,04661;1876;2021;145
1974;82;56,13374;9,0217;1960;2007;47
1974;83;56,08339;8,98743;1972;2021;49
1974;114;55,88581;12,51109;1958;1976;18
1974;117;55,87377;12,4726;1974;1994;20
1974;130;55,67057;11,18151;1899;2021;122
1974;136;55,50785;9,47085;1972;1998;26
1974;163;56,62601;9,85748;1974;1987;13
1974;170;55,50629;9,75098;1964;2001;37
1974;171;55,48663;9,86367;1959;2008;49
1974;203;55,44144;10,37108;1955;1981;26
1974;208;55,74166;11,41925;1865;2021;156
1974;219;55,66464;12,09277;1930;2001;71
1974;223;55,85422;12,46918;1950;1974;24
1974;245;55,35164;11,32714;1938;2021;83
1974;277;56,85548;8,61062;1972;1974;2
1974;299;55,77169;9,47224;1960;2021;61
1974;337;56,13962;10,20498;1928;2004;76
1974;347;56,09986;10,21028;1960;1978;18
1975;3;55,412663;10,12987;1970;2011;41
1975;6;55,269626;10,11524;1877;2009;132
1975;7;55,325496;10,197316;1906;1976;70
1975;34;55,3214857;11,9687601;1891;1987;96
1975;35;55,3225039;11,9608428;1920;2010;90
1975;38;55,973541;12,534777;1946;2021;75
1975;55;55,242371;10,53961;1866;2021;155
1975;64;54,689732;11,964726;1971;2021;50
1975;69;55,182844;9,45901;1920;2004;84
1975;73;55,84433;9,589121;1848;2021;173
1975;77;56,028439;12,589834;1921;2021;100
1975;79;56,051014;12,584655;1969;2008;39
1975;87;55,941434;12,268503;1937;2021;84
1975;88;55,944946;12,309925;1923;2021;98
1975;93;57,356497;9,936222;1890;2021;131
1975;95;55,704063;11,690361;1963;2021;58
1975;101;56,257646;8,279111;1971;1996;25
1975;102;56,359714;8,597986;1973;2004;31
1975;110;55,965642;9,717756;1884;2006;122
1975;131;55,46168;10,663878;1952;2005;53
1975;135;55,482156;9,451854;1949;2021;72
1975;144;55,673798;12,577517;1891;2021;130
1975;145;55,682456;12,569828;1877;2021;144
1975;151;54,861238;10,73061;1867;1978;111
1975;155;56,557877;8,412895;1887;1976;89
1975;156;56,546487;8,414392;1971;2021;50
1975;158;54,815811;11,264489;1905;1996;91
1975;165;56,6472378;9,970264;1954;2021;67
1975;168;55,51314;9,764369;1932;1978;46
1975;194;55,92104;10,25164;1956;2021;65
1975;195;55,9775064;10,1756177;1890;2021;131
1975;196;55,991623;10,251408;1972;2015;43
1975;215;56,886164;9,836899;1886;2009;123
1975;217;56,06639;8,314841;1969;2021;52
1975;230;56,178325;9,590822;1971;2021;50
1975;236;56,090396;9,758625;1892;2021;129
1975;239;56,572888;9,051158;1907;2021;114
1975;248;55,2506641;11,274915;1973;2005;32
1975;255;55,058636;10,606186;1972;1997;25
1975;256;55,070962;10,511664;1920;2021;101
1975;270;56,302138;10,477471;1894;2021;127
1975;271;54,986632;9,977204;1920;2002;82
1975;273;54,898325;9,802925;1952;2021;69
1975;283;55,054318;8,950471;1960;2021;61
1975;294;55,471013;9,099652;1865;2021;156
1975;301;55,643464;9,651961;1889;2021;132
1975;302;55,715222;9,319221;1940;2021;81
1975;307;55,716877;9,585268;1943;2021;78
1975;314;56,377182;9,64424;1972;2021;49
1975;315;56,552152;9,40118;1868;2021;153
1975;316;56,441433;9,422904;1951;2021;70
1975;322;54,9748134;12,2737822;1866;2021;155
1975;328;54,873518;9,518945;1921;2021;100
1975;333;57,005237;9,774809;1915;1990;75
1975;336;56,032176;10,125522;1869;2005;136
1975;339;56,214752;10,27358;1970;2021;51
1975;342;56,1956788;10,2204946;1970;2021;51
1975;343;56,101781;10,070482;1971;2011;40
1975;346;56,067076;10,134812;1866;2021;155
1975;13;55,18902;14,96054;1867;2021;154
1975;23;55,48022;8,43888;1910;2012;102
1975;26;55,28979;8,68128;1970;2021;51
1975;29;56,328077;10,04661;1876;2021;145
1975;82;56,13374;9,0217;1960;2007;47
1975;83;56,08339;8,98743;1972;2021;49
1975;114;55,88581;12,51109;1958;1976;18
1975;117;55,87377;12,4726;1974;1994;20
1975;130;55,67057;11,18151;1899;2021;122
1975;136;55,50785;9,47085;1972;1998;26
1975;163;56,62601;9,85748;1974;1987;13
1975;170;55,50629;9,75098;1964;2001;37
1975;171;55,48663;9,86367;1959;2008;49
1975;203;55,44144;10,37108;1955;1981;26
1975;208;55,74166;11,41925;1865;2021;156
1975;219;55,66464;12,09277;1930;2001;71
1975;245;55,35164;11,32714;1938;2021;83
1975;299;55,77169;9,47224;1960;2021;61
1975;337;56,13962;10,20498;1928;2004;76
1975;347;56,09986;10,21028;1960;1978;18
1976;3;55,412663;10,12987;1970;2011;41
1976;6;55,269626;10,11524;1877;2009;132
1976;7;55,325496;10,197316;1906;1976;70
1976;34;55,3214857;11,9687601;1891;1987;96
1976;35;55,3225039;11,9608428;1920;2010;90
1976;38;55,973541;12,534777;1946;2021;75
1976;55;55,242371;10,53961;1866;2021;155
1976;64;54,689732;11,964726;1971;2021;50
1976;68;55,284145;9,015102;1976;1987;11
1976;69;55,182844;9,45901;1920;2004;84
1976;73;55,84433;9,589121;1848;2021;173
1976;77;56,028439;12,589834;1921;2021;100
1976;79;56,051014;12,584655;1969;2008;39
1976;87;55,941434;12,268503;1937;2021;84
1976;88;55,944946;12,309925;1923;2021;98
1976;93;57,356497;9,936222;1890;2021;131
1976;95;55,704063;11,690361;1963;2021;58
1976;101;56,257646;8,279111;1971;1996;25
1976;102;56,359714;8,597986;1973;2004;31
1976;110;55,965642;9,717756;1884;2006;122
1976;131;55,46168;10,663878;1952;2005;53
1976;135;55,482156;9,451854;1949;2021;72
1976;144;55,673798;12,577517;1891;2021;130
1976;145;55,682456;12,569828;1877;2021;144
1976;151;54,861238;10,73061;1867;1978;111
1976;155;56,557877;8,412895;1887;1976;89
1976;156;56,546487;8,414392;1971;2021;50
1976;158;54,815811;11,264489;1905;1996;91
1976;165;56,6472378;9,970264;1954;2021;67
1976;168;55,51314;9,764369;1932;1978;46
1976;194;55,92104;10,25164;1956;2021;65
1976;195;55,9775064;10,1756177;1890;2021;131
1976;196;55,991623;10,251408;1972;2015;43
1976;215;56,886164;9,836899;1886;2009;123
1976;217;56,06639;8,314841;1969;2021;52
1976;230;56,178325;9,590822;1971;2021;50
1976;236;56,090396;9,758625;1892;2021;129
1976;239;56,572888;9,051158;1907;2021;114
1976;248;55,2506641;11,274915;1973;2005;32
1976;255;55,058636;10,606186;1972;1997;25
1976;256;55,070962;10,511664;1920;2021;101
1976;270;56,302138;10,477471;1894;2021;127
1976;271;54,986632;9,977204;1920;2002;82
1976;273;54,898325;9,802925;1952;2021;69
1976;283;55,054318;8,950471;1960;2021;61
1976;294;55,471013;9,099652;1865;2021;156
1976;301;55,643464;9,651961;1889;2021;132
1976;302;55,715222;9,319221;1940;2021;81
1976;307;55,716877;9,585268;1943;2021;78
1976;314;56,377182;9,64424;1972;2021;49
1976;315;56,552152;9,40118;1868;2021;153
1976;316;56,441433;9,422904;1951;2021;70
1976;322;54,9748134;12,2737822;1866;2021;155
1976;328;54,873518;9,518945;1921;2021;100
1976;333;57,005237;9,774809;1915;1990;75
1976;336;56,032176;10,125522;1869;2005;136
1976;339;56,214752;10,27358;1970;2021;51
1976;342;56,1956788;10,2204946;1970;2021;51
1976;343;56,101781;10,070482;1971;2011;40
1976;346;56,067076;10,134812;1866;2021;155
1976;13;55,18902;14,96054;1867;2021;154
1976;23;55,48022;8,43888;1910;2012;102
1976;26;55,28979;8,68128;1970;2021;51
1976;29;56,328077;10,04661;1876;2021;145
1976;82;56,13374;9,0217;1960;2007;47
1976;83;56,08339;8,98743;1972;2021;49
1976;114;55,88581;12,51109;1958;1976;18
1976;117;55,87377;12,4726;1974;1994;20
1976;130;55,67057;11,18151;1899;2021;122
1976;136;55,50785;9,47085;1972;1998;26
1976;163;56,62601;9,85748;1974;1987;13
1976;170;55,50629;9,75098;1964;2001;37
1976;171;55,48663;9,86367;1959;2008;49
1976;203;55,44144;10,37108;1955;1981;26
1976;208;55,74166;11,41925;1865;2021;156
1976;219;55,66464;12,09277;1930;2001;71
1976;245;55,35164;11,32714;1938;2021;83
1976;299;55,77169;9,47224;1960;2021;61
1976;318;55,0445;12,2726;1976;1986;10
1976;337;56,13962;10,20498;1928;2004;76
1976;347;56,09986;10,21028;1960;1978;18
1977;3;55,412663;10,12987;1970;2011;41
1977;6;55,269626;10,11524;1877;2009;132
1977;34;55,3214857;11,9687601;1891;1987;96
1977;35;55,3225039;11,9608428;1920;2010;90
1977;38;55,973541;12,534777;1946;2021;75
1977;55;55,242371;10,53961;1866;2021;155
1977;64;54,689732;11,964726;1971;2021;50
1977;68;55,284145;9,015102;1976;1987;11
1977;69;55,182844;9,45901;1920;2004;84
1977;72;55,7038449;10,0061417;1977;1996;19
1977;73;55,84433;9,589121;1848;2021;173
1977;77;56,028439;12,589834;1921;2021;100
1977;79;56,051014;12,584655;1969;2008;39
1977;87;55,941434;12,268503;1937;2021;84
1977;88;55,944946;12,309925;1923;2021;98
1977;93;57,356497;9,936222;1890;2021;131
1977;95;55,704063;11,690361;1963;2021;58
1977;101;56,257646;8,279111;1971;1996;25
1977;102;56,359714;8,597986;1973;2004;31
1977;110;55,965642;9,717756;1884;2006;122
1977;131;55,46168;10,663878;1952;2005;53
1977;135;55,482156;9,451854;1949;2021;72
1977;144;55,673798;12,577517;1891;2021;130
1977;145;55,682456;12,569828;1877;2021;144
1977;151;54,861238;10,73061;1867;1978;111
1977;156;56,546487;8,414392;1971;2021;50
1977;158;54,815811;11,264489;1905;1996;91
1977;165;56,6472378;9,970264;1954;2021;67
1977;168;55,51314;9,764369;1932;1978;46
1977;194;55,92104;10,25164;1956;2021;65
1977;195;55,9775064;10,1756177;1890;2021;131
1977;196;55,991623;10,251408;1972;2015;43
1977;215;56,886164;9,836899;1886;2009;123
1977;217;56,06639;8,314841;1969;2021;52
1977;230;56,178325;9,590822;1971;2021;50
1977;236;56,090396;9,758625;1892;2021;129
1977;239;56,572888;9,051158;1907;2021;114
1977;248;55,2506641;11,274915;1973;2005;32
1977;255;55,058636;10,606186;1972;1997;25
1977;256;55,070962;10,511664;1920;2021;101
1977;270;56,302138;10,477471;1894;2021;127
1977;271;54,986632;9,977204;1920;2002;82
1977;273;54,898325;9,802925;1952;2021;69
1977;283;55,054318;8,950471;1960;2021;61
1977;294;55,471013;9,099652;1865;2021;156
1977;301;55,643464;9,651961;1889;2021;132
1977;302;55,715222;9,319221;1940;2021;81
1977;307;55,716877;9,585268;1943;2021;78
1977;314;56,377182;9,64424;1972;2021;49
1977;315;56,552152;9,40118;1868;2021;153
1977;316;56,441433;9,422904;1951;2021;70
1977;322;54,9748134;12,2737822;1866;2021;155
1977;328;54,873518;9,518945;1921;2021;100
1977;333;57,005237;9,774809;1915;1990;75
1977;336;56,032176;10,125522;1869;2005;136
1977;339;56,214752;10,27358;1970;2021;51
1977;342;56,1956788;10,2204946;1970;2021;51
1977;343;56,101781;10,070482;1971;2011;40
1977;346;56,067076;10,134812;1866;2021;155
1977;13;55,18902;14,96054;1867;2021;154
1977;23;55,48022;8,43888;1910;2012;102
1977;26;55,28979;8,68128;1970;2021;51
1977;29;56,328077;10,04661;1876;2021;145
1977;82;56,13374;9,0217;1960;2007;47
1977;83;56,08339;8,98743;1972;2021;49
1977;117;55,87377;12,4726;1974;1994;20
1977;130;55,67057;11,18151;1899;2021;122
1977;136;55,50785;9,47085;1972;1998;26
1977;163;56,62601;9,85748;1974;1987;13
1977;170;55,50629;9,75098;1964;2001;37
1977;171;55,48663;9,86367;1959;2008;49
1977;203;55,44144;10,37108;1955;1981;26
1977;208;55,74166;11,41925;1865;2021;156
1977;219;55,66464;12,09277;1930;2001;71
1977;245;55,35164;11,32714;1938;2021;83
1977;299;55,77169;9,47224;1960;2021;61
1977;318;55,0445;12,2726;1976;1986;10
1977;329;54,96651;9,30635;1977;1995;18
1977;337;56,13962;10,20498;1928;2004;76
1977;347;56,09986;10,21028;1960;1978;18
1978;3;55,412663;10,12987;1970;2011;41
1978;4;55,268008;9,915171;1978;1984;6
1978;6;55,269626;10,11524;1877;2009;132
1978;34;55,3214857;11,9687601;1891;1987;96
1978;35;55,3225039;11,9608428;1920;2010;90
1978;38;55,973541;12,534777;1946;2021;75
1978;55;55,242371;10,53961;1866;2021;155
1978;64;54,689732;11,964726;1971;2021;50
1978;68;55,284145;9,015102;1976;1987;11
1978;69;55,182844;9,45901;1920;2004;84
1978;72;55,7038449;10,0061417;1977;1996;19
1978;73;55,84433;9,589121;1848;2021;173
1978;77;56,028439;12,589834;1921;2021;100
1978;79;56,051014;12,584655;1969;2008;39
1978;87;55,941434;12,268503;1937;2021;84
1978;88;55,944946;12,309925;1923;2021;98
1978;93;57,356497;9,936222;1890;2021;131
1978;95;55,704063;11,690361;1963;2021;58
1978;101;56,257646;8,279111;1971;1996;25
1978;102;56,359714;8,597986;1973;2004;31
1978;110;55,965642;9,717756;1884;2006;122
1978;131;55,46168;10,663878;1952;2005;53
1978;135;55,482156;9,451854;1949;2021;72
1978;144;55,673798;12,577517;1891;2021;130
1978;145;55,682456;12,569828;1877;2021;144
1978;151;54,861238;10,73061;1867;1978;111
1978;156;56,546487;8,414392;1971;2021;50
1978;158;54,815811;11,264489;1905;1996;91
1978;165;56,6472378;9,970264;1954;2021;67
1978;168;55,51314;9,764369;1932;1978;46
1978;194;55,92104;10,25164;1956;2021;65
1978;195;55,9775064;10,1756177;1890;2021;131
1978;196;55,991623;10,251408;1972;2015;43
1978;215;56,886164;9,836899;1886;2009;123
1978;217;56,06639;8,314841;1969;2021;52
1978;230;56,178325;9,590822;1971;2021;50
1978;236;56,090396;9,758625;1892;2021;129
1978;239;56,572888;9,051158;1907;2021;114
1978;248;55,2506641;11,274915;1973;2005;32
1978;255;55,058636;10,606186;1972;1997;25
1978;256;55,070962;10,511664;1920;2021;101
1978;270;56,302138;10,477471;1894;2021;127
1978;271;54,986632;9,977204;1920;2002;82
1978;273;54,898325;9,802925;1952;2021;69
1978;283;55,054318;8,950471;1960;2021;61
1978;294;55,471013;9,099652;1865;2021;156
1978;301;55,643464;9,651961;1889;2021;132
1978;302;55,715222;9,319221;1940;2021;81
1978;307;55,716877;9,585268;1943;2021;78
1978;314;56,377182;9,64424;1972;2021;49
1978;315;56,552152;9,40118;1868;2021;153
1978;316;56,441433;9,422904;1951;2021;70
1978;322;54,9748134;12,2737822;1866;2021;155
1978;325;54,889128;10,412794;1978;2011;33
1978;328;54,873518;9,518945;1921;2021;100
1978;333;57,005237;9,774809;1915;1990;75
1978;336;56,032176;10,125522;1869;2005;136
1978;339;56,214752;10,27358;1970;2021;51
1978;342;56,1956788;10,2204946;1970;2021;51
1978;343;56,101781;10,070482;1971;2011;40
1978;346;56,067076;10,134812;1866;2021;155
1978;13;55,18902;14,96054;1867;2021;154
1978;23;55,48022;8,43888;1910;2012;102
1978;26;55,28979;8,68128;1970;2021;51
1978;29;56,328077;10,04661;1876;2021;145
1978;82;56,13374;9,0217;1960;2007;47
1978;83;56,08339;8,98743;1972;2021;49
1978;117;55,87377;12,4726;1974;1994;20
1978;130;55,67057;11,18151;1899;2021;122
1978;136;55,50785;9,47085;1972;1998;26
1978;163;56,62601;9,85748;1974;1987;13
1978;170;55,50629;9,75098;1964;2001;37
1978;171;55,48663;9,86367;1959;2008;49
1978;203;55,44144;10,37108;1955;1981;26
1978;208;55,74166;11,41925;1865;2021;156
1978;219;55,66464;12,09277;1930;2001;71
1978;245;55,35164;11,32714;1938;2021;83
1978;299;55,77169;9,47224;1960;2021;61
1978;318;55,0445;12,2726;1976;1986;10
1978;329;54,96651;9,30635;1977;1995;18
1978;337;56,13962;10,20498;1928;2004;76
1978;347;56,09986;10,21028;1960;1978;18
1979;3;55,412663;10,12987;1970;2011;41
1979;4;55,268008;9,915171;1978;1984;6
1979;6;55,269626;10,11524;1877;2009;132
1979;34;55,3214857;11,9687601;1891;1987;96
1979;35;55,3225039;11,9608428;1920;2010;90
1979;38;55,973541;12,534777;1946;2021;75
1979;55;55,242371;10,53961;1866;2021;155
1979;64;54,689732;11,964726;1971;2021;50
1979;68;55,284145;9,015102;1976;1987;11
1979;69;55,182844;9,45901;1920;2004;84
1979;72;55,7038449;10,0061417;1977;1996;19
1979;73;55,84433;9,589121;1848;2021;173
1979;77;56,028439;12,589834;1921;2021;100
1979;78;55,9895282;12,5557539;1979;1993;14
1979;79;56,051014;12,584655;1969;2008;39
1979;87;55,941434;12,268503;1937;2021;84
1979;88;55,944946;12,309925;1923;2021;98
1979;93;57,356497;9,936222;1890;2021;131
1979;95;55,704063;11,690361;1963;2021;58
1979;101;56,257646;8,279111;1971;1996;25
1979;102;56,359714;8,597986;1973;2004;31
1979;104;55,92122;9,997713;1979;2000;21
1979;110;55,965642;9,717756;1884;2006;122
1979;131;55,46168;10,663878;1952;2005;53
1979;135;55,482156;9,451854;1949;2021;72
1979;144;55,673798;12,577517;1891;2021;130
1979;145;55,682456;12,569828;1877;2021;144
1979;156;56,546487;8,414392;1971;2021;50
1979;158;54,815811;11,264489;1905;1996;91
1979;165;56,6472378;9,970264;1954;2021;67
1979;194;55,92104;10,25164;1956;2021;65
1979;195;55,9775064;10,1756177;1890;2021;131
1979;196;55,991623;10,251408;1972;2015;43
1979;215;56,886164;9,836899;1886;2009;123
1979;217;56,06639;8,314841;1969;2021;52
1979;230;56,178325;9,590822;1971;2021;50
1979;236;56,090396;9,758625;1892;2021;129
1979;239;56,572888;9,051158;1907;2021;114
1979;248;55,2506641;11,274915;1973;2005;32
1979;255;55,058636;10,606186;1972;1997;25
1979;256;55,070962;10,511664;1920;2021;101
1979;270;56,302138;10,477471;1894;2021;127
1979;271;54,986632;9,977204;1920;2002;82
1979;273;54,898325;9,802925;1952;2021;69
1979;283;55,054318;8,950471;1960;2021;61
1979;294;55,471013;9,099652;1865;2021;156
1979;301;55,643464;9,651961;1889;2021;132
1979;302;55,715222;9,319221;1940;2021;81
1979;307;55,716877;9,585268;1943;2021;78
1979;314;56,377182;9,64424;1972;2021;49
1979;315;56,552152;9,40118;1868;2021;153
1979;316;56,441433;9,422904;1951;2021;70
1979;322;54,9748134;12,2737822;1866;2021;155
1979;325;54,889128;10,412794;1978;2011;33
1979;328;54,873518;9,518945;1921;2021;100
1979;333;57,005237;9,774809;1915;1990;75
1979;336;56,032176;10,125522;1869;2005;136
1979;339;56,214752;10,27358;1970;2021;51
1979;342;56,1956788;10,2204946;1970;2021;51
1979;343;56,101781;10,070482;1971;2011;40
1979;346;56,067076;10,134812;1866;2021;155
1979;13;55,18902;14,96054;1867;2021;154
1979;23;55,48022;8,43888;1910;2012;102
1979;26;55,28979;8,68128;1970;2021;51
1979;29;56,328077;10,04661;1876;2021;145
1979;82;56,13374;9,0217;1960;2007;47
1979;83;56,08339;8,98743;1972;2021;49
1979;117;55,87377;12,4726;1974;1994;20
1979;130;55,67057;11,18151;1899;2021;122
1979;134;55,43241;9,3068;1979;1996;17
1979;136;55,50785;9,47085;1972;1998;26
1979;163;56,62601;9,85748;1974;1987;13
1979;170;55,50629;9,75098;1964;2001;37
1979;171;55,48663;9,86367;1959;2008;49
1979;203;55,44144;10,37108;1955;1981;26
1979;208;55,74166;11,41925;1865;2021;156
1979;219;55,66464;12,09277;1930;2001;71
1979;245;55,35164;11,32714;1938;2021;83
1979;286;55,01112;8,78377;1979;1994;15
1979;299;55,77169;9,47224;1960;2021;61
1979;318;55,0445;12,2726;1976;1986;10
1979;329;54,96651;9,30635;1977;1995;18
1979;337;56,13962;10,20498;1928;2004;76
1980;3;55,412663;10,12987;1970;2011;41
1980;4;55,268008;9,915171;1978;1984;6
1980;6;55,269626;10,11524;1877;2009;132
1980;34;55,3214857;11,9687601;1891;1987;96
1980;35;55,3225039;11,9608428;1920;2010;90
1980;38;55,973541;12,534777;1946;2021;75
1980;55;55,242371;10,53961;1866;2021;155
1980;64;54,689732;11,964726;1971;2021;50
1980;68;55,284145;9,015102;1976;1987;11
1980;69;55,182844;9,45901;1920;2004;84
1980;72;55,7038449;10,0061417;1977;1996;19
1980;73;55,84433;9,589121;1848;2021;173
1980;77;56,028439;12,589834;1921;2021;100
1980;78;55,9895282;12,5557539;1979;1993;14
1980;79;56,051014;12,584655;1969;2008;39
1980;87;55,941434;12,268503;1937;2021;84
1980;88;55,944946;12,309925;1923;2021;98
1980;93;57,356497;9,936222;1890;2021;131
1980;95;55,704063;11,690361;1963;2021;58
1980;101;56,257646;8,279111;1971;1996;25
1980;102;56,359714;8,597986;1973;2004;31
1980;104;55,92122;9,997713;1979;2000;21
1980;110;55,965642;9,717756;1884;2006;122
1980;131;55,46168;10,663878;1952;2005;53
1980;135;55,482156;9,451854;1949;2021;72
1980;144;55,673798;12,577517;1891;2021;130
1980;145;55,682456;12,569828;1877;2021;144
1980;156;56,546487;8,414392;1971;2021;50
1980;158;54,815811;11,264489;1905;1996;91
1980;165;56,6472378;9,970264;1954;2021;67
1980;194;55,92104;10,25164;1956;2021;65
1980;195;55,9775064;10,1756177;1890;2021;131
1980;196;55,991623;10,251408;1972;2015;43
1980;207;55,960508;11,749297;1980;2015;35
1980;215;56,886164;9,836899;1886;2009;123
1980;217;56,06639;8,314841;1969;2021;52
1980;230;56,178325;9,590822;1971;2021;50
1980;236;56,090396;9,758625;1892;2021;129
1980;239;56,572888;9,051158;1907;2021;114
1980;248;55,2506641;11,274915;1973;2005;32
1980;255;55,058636;10,606186;1972;1997;25
1980;256;55,070962;10,511664;1920;2021;101
1980;270;56,302138;10,477471;1894;2021;127
1980;271;54,986632;9,977204;1920;2002;82
1980;273;54,898325;9,802925;1952;2021;69
1980;283;55,054318;8,950471;1960;2021;61
1980;294;55,471013;9,099652;1865;2021;156
1980;301;55,643464;9,651961;1889;2021;132
1980;302;55,715222;9,319221;1940;2021;81
1980;307;55,716877;9,585268;1943;2021;78
1980;314;56,377182;9,64424;1972;2021;49
1980;315;56,552152;9,40118;1868;2021;153
1980;316;56,441433;9,422904;1951;2021;70
1980;322;54,9748134;12,2737822;1866;2021;155
1980;325;54,889128;10,412794;1978;2011;33
1980;328;54,873518;9,518945;1921;2021;100
1980;333;57,005237;9,774809;1915;1990;75
1980;336;56,032176;10,125522;1869;2005;136
1980;339;56,214752;10,27358;1970;2021;51
1980;342;56,1956788;10,2204946;1970;2021;51
1980;343;56,101781;10,070482;1971;2011;40
1980;346;56,067076;10,134812;1866;2021;155
1980;13;55,18902;14,96054;1867;2021;154
1980;23;55,48022;8,43888;1910;2012;102
1980;26;55,28979;8,68128;1970;2021;51
1980;29;56,328077;10,04661;1876;2021;145
1980;82;56,13374;9,0217;1960;2007;47
1980;83;56,08339;8,98743;1972;2021;49
1980;117;55,87377;12,4726;1974;1994;20
1980;130;55,67057;11,18151;1899;2021;122
1980;134;55,43241;9,3068;1979;1996;17
1980;136;55,50785;9,47085;1972;1998;26
1980;163;56,62601;9,85748;1974;1987;13
1980;170;55,50629;9,75098;1964;2001;37
1980;171;55,48663;9,86367;1959;2008;49
1980;203;55,44144;10,37108;1955;1981;26
1980;208;55,74166;11,41925;1865;2021;156
1980;219;55,66464;12,09277;1930;2001;71
1980;245;55,35164;11,32714;1938;2021;83
1980;286;55,01112;8,78377;1979;1994;15
1980;299;55,77169;9,47224;1960;2021;61
1980;318;55,0445;12,2726;1976;1986;10
1980;329;54,96651;9,30635;1977;1995;18
1980;337;56,13962;10,20498;1928;2004;76
1981;3;55,412663;10,12987;1970;2011;41
1981;4;55,268008;9,915171;1978;1984;6
1981;6;55,269626;10,11524;1877;2009;132
1981;34;55,3214857;11,9687601;1891;1987;96
1981;35;55,3225039;11,9608428;1920;2010;90
1981;38;55,973541;12,534777;1946;2021;75
1981;55;55,242371;10,53961;1866;2021;155
1981;64;54,689732;11,964726;1971;2021;50
1981;68;55,284145;9,015102;1976;1987;11
1981;69;55,182844;9,45901;1920;2004;84
1981;72;55,7038449;10,0061417;1977;1996;19
1981;73;55,84433;9,589121;1848;2021;173
1981;77;56,028439;12,589834;1921;2021;100
1981;78;55,9895282;12,5557539;1979;1993;14
1981;79;56,051014;12,584655;1969;2008;39
1981;87;55,941434;12,268503;1937;2021;84
1981;88;55,944946;12,309925;1923;2021;98
1981;93;57,356497;9,936222;1890;2021;131
1981;95;55,704063;11,690361;1963;2021;58
1981;101;56,257646;8,279111;1971;1996;25
1981;102;56,359714;8,597986;1973;2004;31
1981;104;55,92122;9,997713;1979;2000;21
1981;110;55,965642;9,717756;1884;2006;122
1981;131;55,46168;10,663878;1952;2005;53
1981;135;55,482156;9,451854;1949;2021;72
1981;144;55,673798;12,577517;1891;2021;130
1981;145;55,682456;12,569828;1877;2021;144
1981;156;56,546487;8,414392;1971;2021;50
1981;158;54,815811;11,264489;1905;1996;91
1981;165;56,6472378;9,970264;1954;2021;67
1981;194;55,92104;10,25164;1956;2021;65
1981;195;55,9775064;10,1756177;1890;2021;131
1981;196;55,991623;10,251408;1972;2015;43
1981;207;55,960508;11,749297;1980;2015;35
1981;215;56,886164;9,836899;1886;2009;123
1981;217;56,06639;8,314841;1969;2021;52
1981;230;56,178325;9,590822;1971;2021;50
1981;236;56,090396;9,758625;1892;2021;129
1981;239;56,572888;9,051158;1907;2021;114
1981;248;55,2506641;11,274915;1973;2005;32
1981;255;55,058636;10,606186;1972;1997;25
1981;256;55,070962;10,511664;1920;2021;101
1981;270;56,302138;10,477471;1894;2021;127
1981;271;54,986632;9,977204;1920;2002;82
1981;273;54,898325;9,802925;1952;2021;69
1981;283;55,054318;8,950471;1960;2021;61
1981;294;55,471013;9,099652;1865;2021;156
1981;301;55,643464;9,651961;1889;2021;132
1981;302;55,715222;9,319221;1940;2021;81
1981;307;55,716877;9,585268;1943;2021;78
1981;314;56,377182;9,64424;1972;2021;49
1981;315;56,552152;9,40118;1868;2021;153
1981;316;56,441433;9,422904;1951;2021;70
1981;322;54,9748134;12,2737822;1866;2021;155
1981;325;54,889128;10,412794;1978;2011;33
1981;328;54,873518;9,518945;1921;2021;100
1981;333;57,005237;9,774809;1915;1990;75
1981;336;56,032176;10,125522;1869;2005;136
1981;339;56,214752;10,27358;1970;2021;51
1981;342;56,1956788;10,2204946;1970;2021;51
1981;343;56,101781;10,070482;1971;2011;40
1981;346;56,067076;10,134812;1866;2021;155
1981;13;55,18902;14,96054;1867;2021;154
1981;23;55,48022;8,43888;1910;2012;102
1981;26;55,28979;8,68128;1970;2021;51
1981;29;56,328077;10,04661;1876;2021;145
1981;82;56,13374;9,0217;1960;2007;47
1981;83;56,08339;8,98743;1972;2021;49
1981;117;55,87377;12,4726;1974;1994;20
1981;130;55,67057;11,18151;1899;2021;122
1981;134;55,43241;9,3068;1979;1996;17
1981;136;55,50785;9,47085;1972;1998;26
1981;163;56,62601;9,85748;1974;1987;13
1981;170;55,50629;9,75098;1964;2001;37
1981;171;55,48663;9,86367;1959;2008;49
1981;203;55,44144;10,37108;1955;1981;26
1981;208;55,74166;11,41925;1865;2021;156
1981;219;55,66464;12,09277;1930;2001;71
1981;245;55,35164;11,32714;1938;2021;83
1981;286;55,01112;8,78377;1979;1994;15
1981;298;55,4843;9,12621;1981;1993;12
1981;299;55,77169;9,47224;1960;2021;61
1981;309;56,76125;9,23757;1981;1998;17
1981;318;55,0445;12,2726;1976;1986;10
1981;329;54,96651;9,30635;1977;1995;18
1981;337;56,13962;10,20498;1928;2004;76
1982;3;55,412663;10,12987;1970;2011;41
1982;4;55,268008;9,915171;1978;1984;6
1982;6;55,269626;10,11524;1877;2009;132
1982;34;55,3214857;11,9687601;1891;1987;96
1982;35;55,3225039;11,9608428;1920;2010;90
1982;38;55,973541;12,534777;1946;2021;75
1982;55;55,242371;10,53961;1866;2021;155
1982;64;54,689732;11,964726;1971;2021;50
1982;68;55,284145;9,015102;1976;1987;11
1982;69;55,182844;9,45901;1920;2004;84
1982;72;55,7038449;10,0061417;1977;1996;19
1982;73;55,84433;9,589121;1848;2021;173
1982;77;56,028439;12,589834;1921;2021;100
1982;78;55,9895282;12,5557539;1979;1993;14
1982;79;56,051014;12,584655;1969;2008;39
1982;87;55,941434;12,268503;1937;2021;84
1982;88;55,944946;12,309925;1923;2021;98
1982;93;57,356497;9,936222;1890;2021;131
1982;95;55,704063;11,690361;1963;2021;58
1982;101;56,257646;8,279111;1971;1996;25
1982;102;56,359714;8,597986;1973;2004;31
1982;104;55,92122;9,997713;1979;2000;21
1982;110;55,965642;9,717756;1884;2006;122
1982;131;55,46168;10,663878;1952;2005;53
1982;135;55,482156;9,451854;1949;2021;72
1982;144;55,673798;12,577517;1891;2021;130
1982;145;55,682456;12,569828;1877;2021;144
1982;156;56,546487;8,414392;1971;2021;50
1982;158;54,815811;11,264489;1905;1996;91
1982;165;56,6472378;9,970264;1954;2021;67
1982;194;55,92104;10,25164;1956;2021;65
1982;195;55,9775064;10,1756177;1890;2021;131
1982;196;55,991623;10,251408;1972;2015;43
1982;207;55,960508;11,749297;1980;2015;35
1982;215;56,886164;9,836899;1886;2009;123
1982;217;56,06639;8,314841;1969;2021;52
1982;230;56,178325;9,590822;1971;2021;50
1982;236;56,090396;9,758625;1892;2021;129
1982;239;56,572888;9,051158;1907;2021;114
1982;248;55,2506641;11,274915;1973;2005;32
1982;255;55,058636;10,606186;1972;1997;25
1982;256;55,070962;10,511664;1920;2021;101
1982;270;56,302138;10,477471;1894;2021;127
1982;271;54,986632;9,977204;1920;2002;82
1982;273;54,898325;9,802925;1952;2021;69
1982;283;55,054318;8,950471;1960;2021;61
1982;294;55,471013;9,099652;1865;2021;156
1982;301;55,643464;9,651961;1889;2021;132
1982;302;55,715222;9,319221;1940;2021;81
1982;307;55,716877;9,585268;1943;2021;78
1982;314;56,377182;9,64424;1972;2021;49
1982;315;56,552152;9,40118;1868;2021;153
1982;316;56,441433;9,422904;1951;2021;70
1982;322;54,9748134;12,2737822;1866;2021;155
1982;325;54,889128;10,412794;1978;2011;33
1982;328;54,873518;9,518945;1921;2021;100
1982;333;57,005237;9,774809;1915;1990;75
1982;336;56,032176;10,125522;1869;2005;136
1982;339;56,214752;10,27358;1970;2021;51
1982;342;56,1956788;10,2204946;1970;2021;51
1982;343;56,101781;10,070482;1971;2011;40
1982;346;56,067076;10,134812;1866;2021;155
1982;13;55,18902;14,96054;1867;2021;154
1982;23;55,48022;8,43888;1910;2012;102
1982;26;55,28979;8,68128;1970;2021;51
1982;29;56,328077;10,04661;1876;2021;145
1982;82;56,13374;9,0217;1960;2007;47
1982;83;56,08339;8,98743;1972;2021;49
1982;117;55,87377;12,4726;1974;1994;20
1982;130;55,67057;11,18151;1899;2021;122
1982;134;55,43241;9,3068;1979;1996;17
1982;136;55,50785;9,47085;1972;1998;26
1982;163;56,62601;9,85748;1974;1987;13
1982;170;55,50629;9,75098;1964;2001;37
1982;171;55,48663;9,86367;1959;2008;49
1982;208;55,74166;11,41925;1865;2021;156
1982;219;55,66464;12,09277;1930;2001;71
1982;245;55,35164;11,32714;1938;2021;83
1982;250;55,52891;11,50703;1982;1986;4
1982;276;56,95147;8,58714;1982;2000;18
1982;286;55,01112;8,78377;1979;1994;15
1982;298;55,4843;9,12621;1981;1993;12
1982;299;55,77169;9,47224;1960;2021;61
1982;309;56,76125;9,23757;1981;1998;17
1982;318;55,0445;12,2726;1976;1986;10
1982;329;54,96651;9,30635;1977;1995;18
1982;335;57,04003;10,01645;1982;2021;39
1982;337;56,13962;10,20498;1928;2004;76
1983;3;55,412663;10,12987;1970;2011;41
1983;4;55,268008;9,915171;1978;1984;6
1983;6;55,269626;10,11524;1877;2009;132
1983;34;55,3214857;11,9687601;1891;1987;96
1983;35;55,3225039;11,9608428;1920;2010;90
1983;38;55,973541;12,534777;1946;2021;75
1983;55;55,242371;10,53961;1866;2021;155
1983;64;54,689732;11,964726;1971;2021;50
1983;68;55,284145;9,015102;1976;1987;11
1983;69;55,182844;9,45901;1920;2004;84
1983;72;55,7038449;10,0061417;1977;1996;19
1983;73;55,84433;9,589121;1848;2021;173
1983;77;56,028439;12,589834;1921;2021;100
1983;78;55,9895282;12,5557539;1979;1993;14
1983;79;56,051014;12,584655;1969;2008;39
1983;87;55,941434;12,268503;1937;2021;84
1983;88;55,944946;12,309925;1923;2021;98
1983;91;57,585341;9,980745;1983;2004;21
1983;93;57,356497;9,936222;1890;2021;131
1983;95;55,704063;11,690361;1963;2021;58
1983;101;56,257646;8,279111;1971;1996;25
1983;102;56,359714;8,597986;1973;2004;31
1983;104;55,92122;9,997713;1979;2000;21
1983;110;55,965642;9,717756;1884;2006;122
1983;131;55,46168;10,663878;1952;2005;53
1983;133;55,4967868;9,4924387;1983;2001;18
1983;135;55,482156;9,451854;1949;2021;72
1983;144;55,673798;12,577517;1891;2021;130
1983;145;55,682456;12,569828;1877;2021;144
1983;156;56,546487;8,414392;1971;2021;50
1983;158;54,815811;11,264489;1905;1996;91
1983;165;56,6472378;9,970264;1954;2021;67
1983;194;55,92104;10,25164;1956;2021;65
1983;195;55,9775064;10,1756177;1890;2021;131
1983;196;55,991623;10,251408;1972;2015;43
1983;207;55,960508;11,749297;1980;2015;35
1983;215;56,886164;9,836899;1886;2009;123
1983;217;56,06639;8,314841;1969;2021;52
1983;230;56,178325;9,590822;1971;2021;50
1983;236;56,090396;9,758625;1892;2021;129
1983;239;56,572888;9,051158;1907;2021;114
1983;248;55,2506641;11,274915;1973;2005;32
1983;255;55,058636;10,606186;1972;1997;25
1983;256;55,070962;10,511664;1920;2021;101
1983;270;56,302138;10,477471;1894;2021;127
1983;271;54,986632;9,977204;1920;2002;82
1983;273;54,898325;9,802925;1952;2021;69
1983;283;55,054318;8,950471;1960;2021;61
1983;294;55,471013;9,099652;1865;2021;156
1983;301;55,643464;9,651961;1889;2021;132
1983;302;55,715222;9,319221;1940;2021;81
1983;307;55,716877;9,585268;1943;2021;78
1983;314;56,377182;9,64424;1972;2021;49
1983;315;56,552152;9,40118;1868;2021;153
1983;316;56,441433;9,422904;1951;2021;70
1983;322;54,9748134;12,2737822;1866;2021;155
1983;325;54,889128;10,412794;1978;2011;33
1983;328;54,873518;9,518945;1921;2021;100
1983;333;57,005237;9,774809;1915;1990;75
1983;336;56,032176;10,125522;1869;2005;136
1983;339;56,214752;10,27358;1970;2021;51
1983;342;56,1956788;10,2204946;1970;2021;51
1983;343;56,101781;10,070482;1971;2011;40
1983;346;56,067076;10,134812;1866;2021;155
1983;13;55,18902;14,96054;1867;2021;154
1983;16;57,32408;10,12812;1983;1986;3
1983;23;55,48022;8,43888;1910;2012;102
1983;26;55,28979;8,68128;1970;2021;51
1983;29;56,328077;10,04661;1876;2021;145
1983;54;55,25955;10,40146;1983;1988;5
1983;82;56,13374;9,0217;1960;2007;47
1983;83;56,08339;8,98743;1972;2021;49
1983;107;55,86394;9,85899;1983;1985;2
1983;117;55,87377;12,4726;1974;1994;20
1983;130;55,67057;11,18151;1899;2021;122
1983;134;55,43241;9,3068;1979;1996;17
1983;136;55,50785;9,47085;1972;1998;26
1983;163;56,62601;9,85748;1974;1987;13
1983;170;55,50629;9,75098;1964;2001;37
1983;171;55,48663;9,86367;1959;2008;49
1983;208;55,74166;11,41925;1865;2021;156
1983;219;55,66464;12,09277;1930;2001;71
1983;245;55,35164;11,32714;1938;2021;83
1983;250;55,52891;11,50703;1982;1986;4
1983;272;54,89137;9,8371;1983;2001;18
1983;276;56,95147;8,58714;1982;2000;18
1983;286;55,01112;8,78377;1979;1994;15
1983;298;55,4843;9,12621;1981;1993;12
1983;299;55,77169;9,47224;1960;2021;61
1983;309;56,76125;9,23757;1981;1998;17
1983;318;55,0445;12,2726;1976;1986;10
1983;329;54,96651;9,30635;1977;1995;18
1983;335;57,04003;10,01645;1982;2021;39
1983;337;56,13962;10,20498;1928;2004;76
1984;3;55,412663;10,12987;1970;2011;41
1984;4;55,268008;9,915171;1978;1984;6
1984;6;55,269626;10,11524;1877;2009;132
1984;34;55,3214857;11,9687601;1891;1987;96
1984;35;55,3225039;11,9608428;1920;2010;90
1984;38;55,973541;12,534777;1946;2021;75
1984;55;55,242371;10,53961;1866;2021;155
1984;64;54,689732;11,964726;1971;2021;50
1984;68;55,284145;9,015102;1976;1987;11
1984;69;55,182844;9,45901;1920;2004;84
1984;72;55,7038449;10,0061417;1977;1996;19
1984;73;55,84433;9,589121;1848;2021;173
1984;77;56,028439;12,589834;1921;2021;100
1984;78;55,9895282;12,5557539;1979;1993;14
1984;79;56,051014;12,584655;1969;2008;39
1984;87;55,941434;12,268503;1937;2021;84
1984;88;55,944946;12,309925;1923;2021;98
1984;91;57,585341;9,980745;1983;2004;21
1984;93;57,356497;9,936222;1890;2021;131
1984;95;55,704063;11,690361;1963;2021;58
1984;101;56,257646;8,279111;1971;1996;25
1984;102;56,359714;8,597986;1973;2004;31
1984;104;55,92122;9,997713;1979;2000;21
1984;110;55,965642;9,717756;1884;2006;122
1984;131;55,46168;10,663878;1952;2005;53
1984;133;55,4967868;9,4924387;1983;2001;18
1984;135;55,482156;9,451854;1949;2021;72
1984;144;55,673798;12,577517;1891;2021;130
1984;145;55,682456;12,569828;1877;2021;144
1984;156;56,546487;8,414392;1971;2021;50
1984;158;54,815811;11,264489;1905;1996;91
1984;165;56,6472378;9,970264;1954;2021;67
1984;194;55,92104;10,25164;1956;2021;65
1984;195;55,9775064;10,1756177;1890;2021;131
1984;196;55,991623;10,251408;1972;2015;43
1984;207;55,960508;11,749297;1980;2015;35
1984;215;56,886164;9,836899;1886;2009;123
1984;217;56,06639;8,314841;1969;2021;52
1984;225;55,801472;10,556744;1984;2012;28
1984;230;56,178325;9,590822;1971;2021;50
1984;236;56,090396;9,758625;1892;2021;129
1984;239;56,572888;9,051158;1907;2021;114
1984;244;55,350734;11,143543;1984;1990;6
1984;248;55,2506641;11,274915;1973;2005;32
1984;255;55,058636;10,606186;1972;1997;25
1984;256;55,070962;10,511664;1920;2021;101
1984;270;56,302138;10,477471;1894;2021;127
1984;271;54,986632;9,977204;1920;2002;82
1984;273;54,898325;9,802925;1952;2021;69
1984;283;55,054318;8,950471;1960;2021;61
1984;285;55,1913926;9,066302;1984;2021;37
1984;294;55,471013;9,099652;1865;2021;156
1984;301;55,643464;9,651961;1889;2021;132
1984;302;55,715222;9,319221;1940;2021;81
1984;307;55,716877;9,585268;1943;2021;78
1984;314;56,377182;9,64424;1972;2021;49
1984;315;56,552152;9,40118;1868;2021;153
1984;316;56,441433;9,422904;1951;2021;70
1984;322;54,9748134;12,2737822;1866;2021;155
1984;325;54,889128;10,412794;1978;2011;33
1984;328;54,873518;9,518945;1921;2021;100
1984;333;57,005237;9,774809;1915;1990;75
1984;336;56,032176;10,125522;1869;2005;136
1984;339;56,214752;10,27358;1970;2021;51
1984;342;56,1956788;10,2204946;1970;2021;51
1984;343;56,101781;10,070482;1971;2011;40
1984;346;56,067076;10,134812;1866;2021;155
1984;13;55,18902;14,96054;1867;2021;154
1984;16;57,32408;10,12812;1983;1986;3
1984;23;55,48022;8,43888;1910;2012;102
1984;26;55,28979;8,68128;1970;2021;51
1984;29;56,328077;10,04661;1876;2021;145
1984;54;55,25955;10,40146;1983;1988;5
1984;82;56,13374;9,0217;1960;2007;47
1984;83;56,08339;8,98743;1972;2021;49
1984;107;55,86394;9,85899;1983;1985;2
1984;117;55,87377;12,4726;1974;1994;20
1984;130;55,67057;11,18151;1899;2021;122
1984;134;55,43241;9,3068;1979;1996;17
1984;136;55,50785;9,47085;1972;1998;26
1984;149;54,77112;10,71543;1984;2001;17
1984;163;56,62601;9,85748;1974;1987;13
1984;170;55,50629;9,75098;1964;2001;37
1984;171;55,48663;9,86367;1959;2008;49
1984;208;55,74166;11,41925;1865;2021;156
1984;219;55,66464;12,09277;1930;2001;71
1984;245;55,35164;11,32714;1938;2021;83
1984;250;55,52891;11,50703;1982;1986;4
1984;272;54,89137;9,8371;1983;2001;18
1984;276;56,95147;8,58714;1982;2000;18
1984;286;55,01112;8,78377;1979;1994;15
1984;298;55,4843;9,12621;1981;1993;12
1984;299;55,77169;9,47224;1960;2021;61
1984;309;56,76125;9,23757;1981;1998;17
1984;318;55,0445;12,2726;1976;1986;10
1984;329;54,96651;9,30635;1977;1995;18
1984;335;57,04003;10,01645;1982;2021;39
1984;337;56,13962;10,20498;1928;2004;76
1985;3;55,412663;10,12987;1970;2011;41
1985;6;55,269626;10,11524;1877;2009;132
1985;34;55,3214857;11,9687601;1891;1987;96
1985;35;55,3225039;11,9608428;1920;2010;90
1985;38;55,973541;12,534777;1946;2021;75
1985;46;57,623216;10,430582;1985;2011;26
1985;50;55,8569401;12,0706508;1985;2010;25
1985;55;55,242371;10,53961;1866;2021;155
1985;64;54,689732;11,964726;1971;2021;50
1985;68;55,284145;9,015102;1976;1987;11
1985;69;55,182844;9,45901;1920;2004;84
1985;72;55,7038449;10,0061417;1977;1996;19
1985;73;55,84433;9,589121;1848;2021;173
1985;77;56,028439;12,589834;1921;2021;100
1985;78;55,9895282;12,5557539;1979;1993;14
1985;79;56,051014;12,584655;1969;2008;39
1985;87;55,941434;12,268503;1937;2021;84
1985;88;55,944946;12,309925;1923;2021;98
1985;91;57,585341;9,980745;1983;2004;21
1985;93;57,356497;9,936222;1890;2021;131
1985;95;55,704063;11,690361;1963;2021;58
1985;101;56,257646;8,279111;1971;1996;25
1985;102;56,359714;8,597986;1973;2004;31
1985;104;55,92122;9,997713;1979;2000;21
1985;110;55,965642;9,717756;1884;2006;122
1985;131;55,46168;10,663878;1952;2005;53
1985;133;55,4967868;9,4924387;1983;2001;18
1985;135;55,482156;9,451854;1949;2021;72
1985;144;55,673798;12,577517;1891;2021;130
1985;145;55,682456;12,569828;1877;2021;144
1985;156;56,546487;8,414392;1971;2021;50
1985;158;54,815811;11,264489;1905;1996;91
1985;165;56,6472378;9,970264;1954;2021;67
1985;186;55,568493;10,097624;1985;1996;11
1985;194;55,92104;10,25164;1956;2021;65
1985;195;55,9775064;10,1756177;1890;2021;131
1985;196;55,991623;10,251408;1972;2015;43
1985;207;55,960508;11,749297;1980;2015;35
1985;215;56,886164;9,836899;1886;2009;123
1985;217;56,06639;8,314841;1969;2021;52
1985;225;55,801472;10,556744;1984;2012;28
1985;230;56,178325;9,590822;1971;2021;50
1985;236;56,090396;9,758625;1892;2021;129
1985;239;56,572888;9,051158;1907;2021;114
1985;244;55,350734;11,143543;1984;1990;6
1985;248;55,2506641;11,274915;1973;2005;32
1985;255;55,058636;10,606186;1972;1997;25
1985;256;55,070962;10,511664;1920;2021;101
1985;270;56,302138;10,477471;1894;2021;127
1985;271;54,986632;9,977204;1920;2002;82
1985;273;54,898325;9,802925;1952;2021;69
1985;278;56,820065;8,35624;1985;1986;1
1985;283;55,054318;8,950471;1960;2021;61
1985;285;55,1913926;9,066302;1984;2021;37
1985;294;55,471013;9,099652;1865;2021;156
1985;301;55,643464;9,651961;1889;2021;132
1985;302;55,715222;9,319221;1940;2021;81
1985;307;55,716877;9,585268;1943;2021;78
1985;314;56,377182;9,64424;1972;2021;49
1985;315;56,552152;9,40118;1868;2021;153
1985;316;56,441433;9,422904;1951;2021;70
1985;322;54,9748134;12,2737822;1866;2021;155
1985;324;54,924137;10,278204;1985;2021;36
1985;325;54,889128;10,412794;1978;2011;33
1985;328;54,873518;9,518945;1921;2021;100
1985;333;57,005237;9,774809;1915;1990;75
1985;336;56,032176;10,125522;1869;2005;136
1985;339;56,214752;10,27358;1970;2021;51
1985;342;56,1956788;10,2204946;1970;2021;51
1985;343;56,101781;10,070482;1971;2011;40
1985;346;56,067076;10,134812;1866;2021;155
1985;13;55,18902;14,96054;1867;2021;154
1985;16;57,32408;10,12812;1983;1986;3
1985;23;55,48022;8,43888;1910;2012;102
1985;26;55,28979;8,68128;1970;2021;51
1985;29;56,328077;10,04661;1876;2021;145
1985;54;55,25955;10,40146;1983;1988;5
1985;82;56,13374;9,0217;1960;2007;47
1985;83;56,08339;8,98743;1972;2021;49
1985;100;56,25765;8,27911;1985;1996;11
1985;107;55,86394;9,85899;1983;1985;2
1985;117;55,87377;12,4726;1974;1994;20
1985;130;55,67057;11,18151;1899;2021;122
1985;134;55,43241;9,3068;1979;1996;17
1985;136;55,50785;9,47085;1972;1998;26
1985;149;54,77112;10,71543;1984;2001;17
1985;163;56,62601;9,85748;1974;1987;13
1985;170;55,50629;9,75098;1964;2001;37
1985;171;55,48663;9,86367;1959;2008;49
1985;208;55,74166;11,41925;1865;2021;156
1985;219;55,66464;12,09277;1930;2001;71
1985;245;55,35164;11,32714;1938;2021;83
1985;250;55,52891;11,50703;1982;1986;4
1985;272;54,89137;9,8371;1983;2001;18
1985;276;56,95147;8,58714;1982;2000;18
1985;286;55,01112;8,78377;1979;1994;15
1985;291;55,78719;8,25611;1985;2007;22
1985;298;55,4843;9,12621;1981;1993;12
1985;299;55,77169;9,47224;1960;2021;61
1985;309;56,76125;9,23757;1981;1998;17
1985;318;55,0445;12,2726;1976;1986;10
1985;329;54,96651;9,30635;1977;1995;18
1985;335;57,04003;10,01645;1982;2021;39
1985;337;56,13962;10,20498;1928;2004;76
1986;3;55,412663;10,12987;1970;2011;41
1986;6;55,269626;10,11524;1877;2009;132
1986;17;57,277261;9,94587;1986;2021;35
1986;34;55,3214857;11,9687601;1891;1987;96
1986;35;55,3225039;11,9608428;1920;2010;90
1986;38;55,973541;12,534777;1946;2021;75
1986;46;57,623216;10,430582;1985;2011;26
1986;50;55,8569401;12,0706508;1985;2010;25
1986;55;55,242371;10,53961;1866;2021;155
1986;64;54,689732;11,964726;1971;2021;50
1986;68;55,284145;9,015102;1976;1987;11
1986;69;55,182844;9,45901;1920;2004;84
1986;72;55,7038449;10,0061417;1977;1996;19
1986;73;55,84433;9,589121;1848;2021;173
1986;77;56,028439;12,589834;1921;2021;100
1986;78;55,9895282;12,5557539;1979;1993;14
1986;79;56,051014;12,584655;1969;2008;39
1986;84;55,952225;8,782211;1986;2006;20
1986;87;55,941434;12,268503;1937;2021;84
1986;88;55,944946;12,309925;1923;2021;98
1986;91;57,585341;9,980745;1983;2004;21
1986;93;57,356497;9,936222;1890;2021;131
1986;95;55,704063;11,690361;1963;2021;58
1986;101;56,257646;8,279111;1971;1996;25
1986;102;56,359714;8,597986;1973;2004;31
1986;104;55,92122;9,997713;1979;2000;21
1986;110;55,965642;9,717756;1884;2006;122
1986;131;55,46168;10,663878;1952;2005;53
1986;133;55,4967868;9,4924387;1983;2001;18
1986;135;55,482156;9,451854;1949;2021;72
1986;144;55,673798;12,577517;1891;2021;130
1986;145;55,682456;12,569828;1877;2021;144
1986;156;56,546487;8,414392;1971;2021;50
1986;158;54,815811;11,264489;1905;1996;91
1986;159;54,797991;11,516179;1986;2001;15
1986;165;56,6472378;9,970264;1954;2021;67
1986;169;55,490971;9,972686;1986;2021;35
1986;186;55,568493;10,097624;1985;1996;11
1986;194;55,92104;10,25164;1956;2021;65
1986;195;55,9775064;10,1756177;1890;2021;131
1986;196;55,991623;10,251408;1972;2015;43
1986;207;55,960508;11,749297;1980;2015;35
1986;215;56,886164;9,836899;1886;2009;123
1986;217;56,06639;8,314841;1969;2021;52
1986;225;55,801472;10,556744;1984;2012;28
1986;230;56,178325;9,590822;1971;2021;50
1986;236;56,090396;9,758625;1892;2021;129
1986;239;56,572888;9,051158;1907;2021;114
1986;244;55,350734;11,143543;1984;1990;6
1986;248;55,2506641;11,274915;1973;2005;32
1986;255;55,058636;10,606186;1972;1997;25
1986;256;55,070962;10,511664;1920;2021;101
1986;270;56,302138;10,477471;1894;2021;127
1986;271;54,986632;9,977204;1920;2002;82
1986;273;54,898325;9,802925;1952;2021;69
1986;278;56,820065;8,35624;1985;1986;1
1986;283;55,054318;8,950471;1960;2021;61
1986;285;55,1913926;9,066302;1984;2021;37
1986;294;55,471013;9,099652;1865;2021;156
1986;301;55,643464;9,651961;1889;2021;132
1986;302;55,715222;9,319221;1940;2021;81
1986;307;55,716877;9,585268;1943;2021;78
1986;314;56,377182;9,64424;1972;2021;49
1986;315;56,552152;9,40118;1868;2021;153
1986;316;56,441433;9,422904;1951;2021;70
1986;322;54,9748134;12,2737822;1866;2021;155
1986;324;54,924137;10,278204;1985;2021;36
1986;325;54,889128;10,412794;1978;2011;33
1986;328;54,873518;9,518945;1921;2021;100
1986;333;57,005237;9,774809;1915;1990;75
1986;336;56,032176;10,125522;1869;2005;136
1986;339;56,214752;10,27358;1970;2021;51
1986;342;56,1956788;10,2204946;1970;2021;51
1986;343;56,101781;10,070482;1971;2011;40
1986;346;56,067076;10,134812;1866;2021;155
1986;13;55,18902;14,96054;1867;2021;154
1986;16;57,32408;10,12812;1983;1986;3
1986;23;55,48022;8,43888;1910;2012;102
1986;26;55,28979;8,68128;1970;2021;51
1986;29;56,328077;10,04661;1876;2021;145
1986;54;55,25955;10,40146;1983;1988;5
1986;82;56,13374;9,0217;1960;2007;47
1986;83;56,08339;8,98743;1972;2021;49
1986;100;56,25765;8,27911;1985;1996;11
1986;117;55,87377;12,4726;1974;1994;20
1986;130;55,67057;11,18151;1899;2021;122
1986;134;55,43241;9,3068;1979;1996;17
1986;136;55,50785;9,47085;1972;1998;26
1986;149;54,77112;10,71543;1984;2001;17
1986;163;56,62601;9,85748;1974;1987;13
1986;170;55,50629;9,75098;1964;2001;37
1986;171;55,48663;9,86367;1959;2008;49
1986;208;55,74166;11,41925;1865;2021;156
1986;219;55,66464;12,09277;1930;2001;71
1986;245;55,35164;11,32714;1938;2021;83
1986;250;55,52891;11,50703;1982;1986;4
1986;272;54,89137;9,8371;1983;2001;18
1986;276;56,95147;8,58714;1982;2000;18
1986;286;55,01112;8,78377;1979;1994;15
1986;291;55,78719;8,25611;1985;2007;22
1986;298;55,4843;9,12621;1981;1993;12
1986;299;55,77169;9,47224;1960;2021;61
1986;309;56,76125;9,23757;1981;1998;17
1986;318;55,0445;12,2726;1976;1986;10
1986;329;54,96651;9,30635;1977;1995;18
1986;335;57,04003;10,01645;1982;2021;39
1986;337;56,13962;10,20498;1928;2004;76
1987;3;55,412663;10,12987;1970;2011;41
1987;6;55,269626;10,11524;1877;2009;132
1987;17;57,277261;9,94587;1986;2021;35
1987;34;55,3214857;11,9687601;1891;1987;96
1987;35;55,3225039;11,9608428;1920;2010;90
1987;38;55,973541;12,534777;1946;2021;75
1987;39;55,985157;12,454491;1987;1988;1
1987;46;57,623216;10,430582;1985;2011;26
1987;50;55,8569401;12,0706508;1985;2010;25
1987;55;55,242371;10,53961;1866;2021;155
1987;64;54,689732;11,964726;1971;2021;50
1987;68;55,284145;9,015102;1976;1987;11
1987;69;55,182844;9,45901;1920;2004;84
1987;72;55,7038449;10,0061417;1977;1996;19
1987;73;55,84433;9,589121;1848;2021;173
1987;77;56,028439;12,589834;1921;2021;100
1987;78;55,9895282;12,5557539;1979;1993;14
1987;79;56,051014;12,584655;1969;2008;39
1987;84;55,952225;8,782211;1986;2006;20
1987;87;55,941434;12,268503;1937;2021;84
1987;88;55,944946;12,309925;1923;2021;98
1987;91;57,585341;9,980745;1983;2004;21
1987;93;57,356497;9,936222;1890;2021;131
1987;95;55,704063;11,690361;1963;2021;58
1987;101;56,257646;8,279111;1971;1996;25
1987;102;56,359714;8,597986;1973;2004;31
1987;104;55,92122;9,997713;1979;2000;21
1987;110;55,965642;9,717756;1884;2006;122
1987;131;55,46168;10,663878;1952;2005;53
1987;133;55,4967868;9,4924387;1983;2001;18
1987;135;55,482156;9,451854;1949;2021;72
1987;144;55,673798;12,577517;1891;2021;130
1987;145;55,682456;12,569828;1877;2021;144
1987;156;56,546487;8,414392;1971;2021;50
1987;158;54,815811;11,264489;1905;1996;91
1987;159;54,797991;11,516179;1986;2001;15
1987;165;56,6472378;9,970264;1954;2021;67
1987;169;55,490971;9,972686;1986;2021;35
1987;186;55,568493;10,097624;1985;1996;11
1987;194;55,92104;10,25164;1956;2021;65
1987;195;55,9775064;10,1756177;1890;2021;131
1987;196;55,991623;10,251408;1972;2015;43
1987;207;55,960508;11,749297;1980;2015;35
1987;214;56,770854;9,874628;1987;1988;1
1987;215;56,886164;9,836899;1886;2009;123
1987;217;56,06639;8,314841;1969;2021;52
1987;225;55,801472;10,556744;1984;2012;28
1987;230;56,178325;9,590822;1971;2021;50
1987;236;56,090396;9,758625;1892;2021;129
1987;239;56,572888;9,051158;1907;2021;114
1987;244;55,350734;11,143543;1984;1990;6
1987;248;55,2506641;11,274915;1973;2005;32
1987;255;55,058636;10,606186;1972;1997;25
1987;256;55,070962;10,511664;1920;2021;101
1987;270;56,302138;10,477471;1894;2021;127
1987;271;54,986632;9,977204;1920;2002;82
1987;273;54,898325;9,802925;1952;2021;69
1987;283;55,054318;8,950471;1960;2021;61
1987;285;55,1913926;9,066302;1984;2021;37
1987;294;55,471013;9,099652;1865;2021;156
1987;301;55,643464;9,651961;1889;2021;132
1987;302;55,715222;9,319221;1940;2021;81
1987;307;55,716877;9,585268;1943;2021;78
1987;314;56,377182;9,64424;1972;2021;49
1987;315;56,552152;9,40118;1868;2021;153
1987;316;56,441433;9,422904;1951;2021;70
1987;322;54,9748134;12,2737822;1866;2021;155
1987;324;54,924137;10,278204;1985;2021;36
1987;325;54,889128;10,412794;1978;2011;33
1987;328;54,873518;9,518945;1921;2021;100
1987;333;57,005237;9,774809;1915;1990;75
1987;336;56,032176;10,125522;1869;2005;136
1987;339;56,214752;10,27358;1970;2021;51
1987;342;56,1956788;10,2204946;1970;2021;51
1987;343;56,101781;10,070482;1971;2011;40
1987;346;56,067076;10,134812;1866;2021;155
1987;13;55,18902;14,96054;1867;2021;154
1987;23;55,48022;8,43888;1910;2012;102
1987;26;55,28979;8,68128;1970;2021;51
1987;29;56,328077;10,04661;1876;2021;145
1987;37;55,91688;12,42258;1987;1996;9
1987;54;55,25955;10,40146;1983;1988;5
1987;82;56,13374;9,0217;1960;2007;47
1987;83;56,08339;8,98743;1972;2021;49
1987;100;56,25765;8,27911;1985;1996;11
1987;117;55,87377;12,4726;1974;1994;20
1987;130;55,67057;11,18151;1899;2021;122
1987;134;55,43241;9,3068;1979;1996;17
1987;136;55,50785;9,47085;1972;1998;26
1987;149;54,77112;10,71543;1984;2001;17
1987;163;56,62601;9,85748;1974;1987;13
1987;170;55,50629;9,75098;1964;2001;37
1987;171;55,48663;9,86367;1959;2008;49
1987;208;55,74166;11,41925;1865;2021;156
1987;219;55,66464;12,09277;1930;2001;71
1987;245;55,35164;11,32714;1938;2021;83
1987;272;54,89137;9,8371;1983;2001;18
1987;276;56,95147;8,58714;1982;2000;18
1987;286;55,01112;8,78377;1979;1994;15
1987;291;55,78719;8,25611;1985;2007;22
1987;298;55,4843;9,12621;1981;1993;12
1987;299;55,77169;9,47224;1960;2021;61
1987;309;56,76125;9,23757;1981;1998;17
1987;329;54,96651;9,30635;1977;1995;18
1987;335;57,04003;10,01645;1982;2021;39
1987;337;56,13962;10,20498;1928;2004;76
1988;3;55,412663;10,12987;1970;2011;41
1988;6;55,269626;10,11524;1877;2009;132
1988;17;57,277261;9,94587;1986;2021;35
1988;35;55,3225039;11,9608428;1920;2010;90
1988;38;55,973541;12,534777;1946;2021;75
1988;39;55,985157;12,454491;1987;1988;1
1988;46;57,623216;10,430582;1985;2011;26
1988;50;55,8569401;12,0706508;1985;2010;25
1988;55;55,242371;10,53961;1866;2021;155
1988;64;54,689732;11,964726;1971;2021;50
1988;69;55,182844;9,45901;1920;2004;84
1988;72;55,7038449;10,0061417;1977;1996;19
1988;73;55,84433;9,589121;1848;2021;173
1988;77;56,028439;12,589834;1921;2021;100
1988;78;55,9895282;12,5557539;1979;1993;14
1988;79;56,051014;12,584655;1969;2008;39
1988;84;55,952225;8,782211;1986;2006;20
1988;87;55,941434;12,268503;1937;2021;84
1988;88;55,944946;12,309925;1923;2021;98
1988;91;57,585341;9,980745;1983;2004;21
1988;93;57,356497;9,936222;1890;2021;131
1988;95;55,704063;11,690361;1963;2021;58
1988;101;56,257646;8,279111;1971;1996;25
1988;102;56,359714;8,597986;1973;2004;31
1988;104;55,92122;9,997713;1979;2000;21
1988;110;55,965642;9,717756;1884;2006;122
1988;131;55,46168;10,663878;1952;2005;53
1988;133;55,4967868;9,4924387;1983;2001;18
1988;135;55,482156;9,451854;1949;2021;72
1988;144;55,673798;12,577517;1891;2021;130
1988;145;55,682456;12,569828;1877;2021;144
1988;156;56,546487;8,414392;1971;2021;50
1988;158;54,815811;11,264489;1905;1996;91
1988;159;54,797991;11,516179;1986;2001;15
1988;165;56,6472378;9,970264;1954;2021;67
1988;169;55,490971;9,972686;1986;2021;35
1988;186;55,568493;10,097624;1985;1996;11
1988;194;55,92104;10,25164;1956;2021;65
1988;195;55,9775064;10,1756177;1890;2021;131
1988;196;55,991623;10,251408;1972;2015;43
1988;207;55,960508;11,749297;1980;2015;35
1988;214;56,770854;9,874628;1987;1988;1
1988;215;56,886164;9,836899;1886;2009;123
1988;217;56,06639;8,314841;1969;2021;52
1988;225;55,801472;10,556744;1984;2012;28
1988;230;56,178325;9,590822;1971;2021;50
1988;236;56,090396;9,758625;1892;2021;129
1988;239;56,572888;9,051158;1907;2021;114
1988;244;55,350734;11,143543;1984;1990;6
1988;248;55,2506641;11,274915;1973;2005;32
1988;255;55,058636;10,606186;1972;1997;25
1988;256;55,070962;10,511664;1920;2021;101
1988;270;56,302138;10,477471;1894;2021;127
1988;271;54,986632;9,977204;1920;2002;82
1988;273;54,898325;9,802925;1952;2021;69
1988;283;55,054318;8,950471;1960;2021;61
1988;285;55,1913926;9,066302;1984;2021;37
1988;294;55,471013;9,099652;1865;2021;156
1988;301;55,643464;9,651961;1889;2021;132
1988;302;55,715222;9,319221;1940;2021;81
1988;307;55,716877;9,585268;1943;2021;78
1988;314;56,377182;9,64424;1972;2021;49
1988;315;56,552152;9,40118;1868;2021;153
1988;316;56,441433;9,422904;1951;2021;70
1988;322;54,9748134;12,2737822;1866;2021;155
1988;324;54,924137;10,278204;1985;2021;36
1988;325;54,889128;10,412794;1978;2011;33
1988;328;54,873518;9,518945;1921;2021;100
1988;333;57,005237;9,774809;1915;1990;75
1988;336;56,032176;10,125522;1869;2005;136
1988;339;56,214752;10,27358;1970;2021;51
1988;342;56,1956788;10,2204946;1970;2021;51
1988;343;56,101781;10,070482;1971;2011;40
1988;346;56,067076;10,134812;1866;2021;155
1988;13;55,18902;14,96054;1867;2021;154
1988;23;55,48022;8,43888;1910;2012;102
1988;26;55,28979;8,68128;1970;2021;51
1988;29;56,328077;10,04661;1876;2021;145
1988;37;55,91688;12,42258;1987;1996;9
1988;54;55,25955;10,40146;1983;1988;5
1988;82;56,13374;9,0217;1960;2007;47
1988;83;56,08339;8,98743;1972;2021;49
1988;100;56,25765;8,27911;1985;1996;11
1988;117;55,87377;12,4726;1974;1994;20
1988;130;55,67057;11,18151;1899;2021;122
1988;134;55,43241;9,3068;1979;1996;17
1988;136;55,50785;9,47085;1972;1998;26
1988;149;54,77112;10,71543;1984;2001;17
1988;170;55,50629;9,75098;1964;2001;37
1988;171;55,48663;9,86367;1959;2008;49
1988;208;55,74166;11,41925;1865;2021;156
1988;219;55,66464;12,09277;1930;2001;71
1988;245;55,35164;11,32714;1938;2021;83
1988;272;54,89137;9,8371;1983;2001;18
1988;276;56,95147;8,58714;1982;2000;18
1988;286;55,01112;8,78377;1979;1994;15
1988;291;55,78719;8,25611;1985;2007;22
1988;298;55,4843;9,12621;1981;1993;12
1988;299;55,77169;9,47224;1960;2021;61
1988;309;56,76125;9,23757;1981;1998;17
1988;329;54,96651;9,30635;1977;1995;18
1988;335;57,04003;10,01645;1982;2021;39
1988;337;56,13962;10,20498;1928;2004;76
1989;3;55,412663;10,12987;1970;2011;41
1989;6;55,269626;10,11524;1877;2009;132
1989;17;57,277261;9,94587;1986;2021;35
1989;35;55,3225039;11,9608428;1920;2010;90
1989;38;55,973541;12,534777;1946;2021;75
1989;46;57,623216;10,430582;1985;2011;26
1989;50;55,8569401;12,0706508;1985;2010;25
1989;55;55,242371;10,53961;1866;2021;155
1989;64;54,689732;11,964726;1971;2021;50
1989;69;55,182844;9,45901;1920;2004;84
1989;72;55,7038449;10,0061417;1977;1996;19
1989;73;55,84433;9,589121;1848;2021;173
1989;77;56,028439;12,589834;1921;2021;100
1989;78;55,9895282;12,5557539;1979;1993;14
1989;79;56,051014;12,584655;1969;2008;39
1989;84;55,952225;8,782211;1986;2006;20
1989;87;55,941434;12,268503;1937;2021;84
1989;88;55,944946;12,309925;1923;2021;98
1989;91;57,585341;9,980745;1983;2004;21
1989;93;57,356497;9,936222;1890;2021;131
1989;95;55,704063;11,690361;1963;2021;58
1989;101;56,257646;8,279111;1971;1996;25
1989;102;56,359714;8,597986;1973;2004;31
1989;104;55,92122;9,997713;1979;2000;21
1989;110;55,965642;9,717756;1884;2006;122
1989;131;55,46168;10,663878;1952;2005;53
1989;133;55,4967868;9,4924387;1983;2001;18
1989;135;55,482156;9,451854;1949;2021;72
1989;144;55,673798;12,577517;1891;2021;130
1989;145;55,682456;12,569828;1877;2021;144
1989;156;56,546487;8,414392;1971;2021;50
1989;158;54,815811;11,264489;1905;1996;91
1989;159;54,797991;11,516179;1986;2001;15
1989;165;56,6472378;9,970264;1954;2021;67
1989;169;55,490971;9,972686;1986;2021;35
1989;186;55,568493;10,097624;1985;1996;11
1989;194;55,92104;10,25164;1956;2021;65
1989;195;55,9775064;10,1756177;1890;2021;131
1989;196;55,991623;10,251408;1972;2015;43
1989;207;55,960508;11,749297;1980;2015;35
1989;215;56,886164;9,836899;1886;2009;123
1989;217;56,06639;8,314841;1969;2021;52
1989;225;55,801472;10,556744;1984;2012;28
1989;230;56,178325;9,590822;1971;2021;50
1989;236;56,090396;9,758625;1892;2021;129
1989;239;56,572888;9,051158;1907;2021;114
1989;244;55,350734;11,143543;1984;1990;6
1989;248;55,2506641;11,274915;1973;2005;32
1989;255;55,058636;10,606186;1972;1997;25
1989;256;55,070962;10,511664;1920;2021;101
1989;258;55,1225643;10,7284368;1989;2021;32
1989;270;56,302138;10,477471;1894;2021;127
1989;271;54,986632;9,977204;1920;2002;82
1989;273;54,898325;9,802925;1952;2021;69
1989;283;55,054318;8,950471;1960;2021;61
1989;285;55,1913926;9,066302;1984;2021;37
1989;294;55,471013;9,099652;1865;2021;156
1989;301;55,643464;9,651961;1889;2021;132
1989;302;55,715222;9,319221;1940;2021;81
1989;307;55,716877;9,585268;1943;2021;78
1989;314;56,377182;9,64424;1972;2021;49
1989;315;56,552152;9,40118;1868;2021;153
1989;316;56,441433;9,422904;1951;2021;70
1989;322;54,9748134;12,2737822;1866;2021;155
1989;324;54,924137;10,278204;1985;2021;36
1989;325;54,889128;10,412794;1978;2011;33
1989;328;54,873518;9,518945;1921;2021;100
1989;333;57,005237;9,774809;1915;1990;75
1989;336;56,032176;10,125522;1869;2005;136
1989;339;56,214752;10,27358;1970;2021;51
1989;342;56,1956788;10,2204946;1970;2021;51
1989;343;56,101781;10,070482;1971;2011;40
1989;346;56,067076;10,134812;1866;2021;155
1989;13;55,18902;14,96054;1867;2021;154
1989;23;55,48022;8,43888;1910;2012;102
1989;26;55,28979;8,68128;1970;2021;51
1989;29;56,328077;10,04661;1876;2021;145
1989;37;55,91688;12,42258;1987;1996;9
1989;82;56,13374;9,0217;1960;2007;47
1989;83;56,08339;8,98743;1972;2021;49
1989;100;56,25765;8,27911;1985;1996;11
1989;117;55,87377;12,4726;1974;1994;20
1989;130;55,67057;11,18151;1899;2021;122
1989;134;55,43241;9,3068;1979;1996;17
1989;136;55,50785;9,47085;1972;1998;26
1989;149;54,77112;10,71543;1984;2001;17
1989;170;55,50629;9,75098;1964;2001;37
1989;171;55,48663;9,86367;1959;2008;49
1989;208;55,74166;11,41925;1865;2021;156
1989;219;55,66464;12,09277;1930;2001;71
1989;245;55,35164;11,32714;1938;2021;83
1989;272;54,89137;9,8371;1983;2001;18
1989;276;56,95147;8,58714;1982;2000;18
1989;286;55,01112;8,78377;1979;1994;15
1989;291;55,78719;8,25611;1985;2007;22
1989;298;55,4843;9,12621;1981;1993;12
1989;299;55,77169;9,47224;1960;2021;61
1989;309;56,76125;9,23757;1981;1998;17
1989;329;54,96651;9,30635;1977;1995;18
1989;335;57,04003;10,01645;1982;2021;39
1989;337;56,13962;10,20498;1928;2004;76
1990;3;55,412663;10,12987;1970;2011;41
1990;6;55,269626;10,11524;1877;2009;132
1990;17;57,277261;9,94587;1986;2021;35
1990;35;55,3225039;11,9608428;1920;2010;90
1990;38;55,973541;12,534777;1946;2021;75
1990;46;57,623216;10,430582;1985;2011;26
1990;50;55,8569401;12,0706508;1985;2010;25
1990;55;55,242371;10,53961;1866;2021;155
1990;64;54,689732;11,964726;1971;2021;50
1990;69;55,182844;9,45901;1920;2004;84
1990;72;55,7038449;10,0061417;1977;1996;19
1990;73;55,84433;9,589121;1848;2021;173
1990;77;56,028439;12,589834;1921;2021;100
1990;78;55,9895282;12,5557539;1979;1993;14
1990;79;56,051014;12,584655;1969;2008;39
1990;84;55,952225;8,782211;1986;2006;20
1990;87;55,941434;12,268503;1937;2021;84
1990;88;55,944946;12,309925;1923;2021;98
1990;91;57,585341;9,980745;1983;2004;21
1990;93;57,356497;9,936222;1890;2021;131
1990;95;55,704063;11,690361;1963;2021;58
1990;101;56,257646;8,279111;1971;1996;25
1990;102;56,359714;8,597986;1973;2004;31
1990;104;55,92122;9,997713;1979;2000;21
1990;110;55,965642;9,717756;1884;2006;122
1990;131;55,46168;10,663878;1952;2005;53
1990;133;55,4967868;9,4924387;1983;2001;18
1990;135;55,482156;9,451854;1949;2021;72
1990;144;55,673798;12,577517;1891;2021;130
1990;145;55,682456;12,569828;1877;2021;144
1990;156;56,546487;8,414392;1971;2021;50
1990;158;54,815811;11,264489;1905;1996;91
1990;159;54,797991;11,516179;1986;2001;15
1990;165;56,6472378;9,970264;1954;2021;67
1990;169;55,490971;9,972686;1986;2021;35
1990;186;55,568493;10,097624;1985;1996;11
1990;194;55,92104;10,25164;1956;2021;65
1990;195;55,9775064;10,1756177;1890;2021;131
1990;196;55,991623;10,251408;1972;2015;43
1990;207;55,960508;11,749297;1980;2015;35
1990;215;56,886164;9,836899;1886;2009;123
1990;217;56,06639;8,314841;1969;2021;52
1990;225;55,801472;10,556744;1984;2012;28
1990;230;56,178325;9,590822;1971;2021;50
1990;236;56,090396;9,758625;1892;2021;129
1990;239;56,572888;9,051158;1907;2021;114
1990;244;55,350734;11,143543;1984;1990;6
1990;248;55,2506641;11,274915;1973;2005;32
1990;255;55,058636;10,606186;1972;1997;25
1990;256;55,070962;10,511664;1920;2021;101
1990;258;55,1225643;10,7284368;1989;2021;32
1990;270;56,302138;10,477471;1894;2021;127
1990;271;54,986632;9,977204;1920;2002;82
1990;273;54,898325;9,802925;1952;2021;69
1990;283;55,054318;8,950471;1960;2021;61
1990;285;55,1913926;9,066302;1984;2021;37
1990;294;55,471013;9,099652;1865;2021;156
1990;301;55,643464;9,651961;1889;2021;132
1990;302;55,715222;9,319221;1940;2021;81
1990;307;55,716877;9,585268;1943;2021;78
1990;314;56,377182;9,64424;1972;2021;49
1990;315;56,552152;9,40118;1868;2021;153
1990;316;56,441433;9,422904;1951;2021;70
1990;322;54,9748134;12,2737822;1866;2021;155
1990;324;54,924137;10,278204;1985;2021;36
1990;325;54,889128;10,412794;1978;2011;33
1990;328;54,873518;9,518945;1921;2021;100
1990;333;57,005237;9,774809;1915;1990;75
1990;336;56,032176;10,125522;1869;2005;136
1990;339;56,214752;10,27358;1970;2021;51
1990;342;56,1956788;10,2204946;1970;2021;51
1990;343;56,101781;10,070482;1971;2011;40
1990;346;56,067076;10,134812;1866;2021;155
1990;13;55,18902;14,96054;1867;2021;154
1990;23;55,48022;8,43888;1910;2012;102
1990;26;55,28979;8,68128;1970;2021;51
1990;29;56,328077;10,04661;1876;2021;145
1990;37;55,91688;12,42258;1987;1996;9
1990;82;56,13374;9,0217;1960;2007;47
1990;83;56,08339;8,98743;1972;2021;49
1990;100;56,25765;8,27911;1985;1996;11
1990;117;55,87377;12,4726;1974;1994;20
1990;130;55,67057;11,18151;1899;2021;122
1990;134;55,43241;9,3068;1979;1996;17
1990;136;55,50785;9,47085;1972;1998;26
1990;149;54,77112;10,71543;1984;2001;17
1990;170;55,50629;9,75098;1964;2001;37
1990;171;55,48663;9,86367;1959;2008;49
1990;208;55,74166;11,41925;1865;2021;156
1990;219;55,66464;12,09277;1930;2001;71
1990;245;55,35164;11,32714;1938;2021;83
1990;272;54,89137;9,8371;1983;2001;18
1990;276;56,95147;8,58714;1982;2000;18
1990;286;55,01112;8,78377;1979;1994;15
1990;291;55,78719;8,25611;1985;2007;22
1990;298;55,4843;9,12621;1981;1993;12
1990;299;55,77169;9,47224;1960;2021;61
1990;309;56,76125;9,23757;1981;1998;17
1990;329;54,96651;9,30635;1977;1995;18
1990;335;57,04003;10,01645;1982;2021;39
1990;337;56,13962;10,20498;1928;2004;76
1991;3;55,412663;10,12987;1970;2011;41
1991;6;55,269626;10,11524;1877;2009;132
1991;17;57,277261;9,94587;1986;2021;35
1991;35;55,3225039;11,9608428;1920;2010;90
1991;38;55,973541;12,534777;1946;2021;75
1991;46;57,623216;10,430582;1985;2011;26
1991;50;55,8569401;12,0706508;1985;2010;25
1991;55;55,242371;10,53961;1866;2021;155
1991;64;54,689732;11,964726;1971;2021;50
1991;69;55,182844;9,45901;1920;2004;84
1991;72;55,7038449;10,0061417;1977;1996;19
1991;73;55,84433;9,589121;1848;2021;173
1991;77;56,028439;12,589834;1921;2021;100
1991;78;55,9895282;12,5557539;1979;1993;14
1991;79;56,051014;12,584655;1969;2008;39
1991;84;55,952225;8,782211;1986;2006;20
1991;87;55,941434;12,268503;1937;2021;84
1991;88;55,944946;12,309925;1923;2021;98
1991;91;57,585341;9,980745;1983;2004;21
1991;93;57,356497;9,936222;1890;2021;131
1991;95;55,704063;11,690361;1963;2021;58
1991;101;56,257646;8,279111;1971;1996;25
1991;102;56,359714;8,597986;1973;2004;31
1991;104;55,92122;9,997713;1979;2000;21
1991;110;55,965642;9,717756;1884;2006;122
1991;131;55,46168;10,663878;1952;2005;53
1991;133;55,4967868;9,4924387;1983;2001;18
1991;135;55,482156;9,451854;1949;2021;72
1991;144;55,673798;12,577517;1891;2021;130
1991;145;55,682456;12,569828;1877;2021;144
1991;156;56,546487;8,414392;1971;2021;50
1991;158;54,815811;11,264489;1905;1996;91
1991;159;54,797991;11,516179;1986;2001;15
1991;165;56,6472378;9,970264;1954;2021;67
1991;169;55,490971;9,972686;1986;2021;35
1991;186;55,568493;10,097624;1985;1996;11
1991;194;55,92104;10,25164;1956;2021;65
1991;195;55,9775064;10,1756177;1890;2021;131
1991;196;55,991623;10,251408;1972;2015;43
1991;204;55,837896;11,551628;1991;2021;30
1991;207;55,960508;11,749297;1980;2015;35
1991;215;56,886164;9,836899;1886;2009;123
1991;217;56,06639;8,314841;1969;2021;52
1991;218;55,512414;11,688584;1991;2000;9
1991;225;55,801472;10,556744;1984;2012;28
1991;230;56,178325;9,590822;1971;2021;50
1991;236;56,090396;9,758625;1892;2021;129
1991;238;56,545839;9,028644;1991;1992;1
1991;239;56,572888;9,051158;1907;2021;114
1991;248;55,2506641;11,274915;1973;2005;32
1991;255;55,058636;10,606186;1972;1997;25
1991;256;55,070962;10,511664;1920;2021;101
1991;258;55,1225643;10,7284368;1989;2021;32
1991;270;56,302138;10,477471;1894;2021;127
1991;271;54,986632;9,977204;1920;2002;82
1991;273;54,898325;9,802925;1952;2021;69
1991;283;55,054318;8,950471;1960;2021;61
1991;285;55,1913926;9,066302;1984;2021;37
1991;294;55,471013;9,099652;1865;2021;156
1991;301;55,643464;9,651961;1889;2021;132
1991;302;55,715222;9,319221;1940;2021;81
1991;307;55,716877;9,585268;1943;2021;78
1991;314;56,377182;9,64424;1972;2021;49
1991;315;56,552152;9,40118;1868;2021;153
1991;316;56,441433;9,422904;1951;2021;70
1991;322;54,9748134;12,2737822;1866;2021;155
1991;324;54,924137;10,278204;1985;2021;36
1991;325;54,889128;10,412794;1978;2011;33
1991;328;54,873518;9,518945;1921;2021;100
1991;336;56,032176;10,125522;1869;2005;136
1991;339;56,214752;10,27358;1970;2021;51
1991;342;56,1956788;10,2204946;1970;2021;51
1991;343;56,101781;10,070482;1971;2011;40
1991;346;56,067076;10,134812;1866;2021;155
1991;13;55,18902;14,96054;1867;2021;154
1991;23;55,48022;8,43888;1910;2012;102
1991;26;55,28979;8,68128;1970;2021;51
1991;29;56,328077;10,04661;1876;2021;145
1991;37;55,91688;12,42258;1987;1996;9
1991;82;56,13374;9,0217;1960;2007;47
1991;83;56,08339;8,98743;1972;2021;49
1991;100;56,25765;8,27911;1985;1996;11
1991;117;55,87377;12,4726;1974;1994;20
1991;130;55,67057;11,18151;1899;2021;122
1991;134;55,43241;9,3068;1979;1996;17
1991;136;55,50785;9,47085;1972;1998;26
1991;149;54,77112;10,71543;1984;2001;17
1991;170;55,50629;9,75098;1964;2001;37
1991;171;55,48663;9,86367;1959;2008;49
1991;208;55,74166;11,41925;1865;2021;156
1991;219;55,66464;12,09277;1930;2001;71
1991;245;55,35164;11,32714;1938;2021;83
1991;272;54,89137;9,8371;1983;2001;18
1991;276;56,95147;8,58714;1982;2000;18
1991;286;55,01112;8,78377;1979;1994;15
1991;291;55,78719;8,25611;1985;2007;22
1991;298;55,4843;9,12621;1981;1993;12
1991;299;55,77169;9,47224;1960;2021;61
1991;309;56,76125;9,23757;1981;1998;17
1991;329;54,96651;9,30635;1977;1995;18
1991;335;57,04003;10,01645;1982;2021;39
1991;337;56,13962;10,20498;1928;2004;76
1992;3;55,412663;10,12987;1970;2011;41
1992;6;55,269626;10,11524;1877;2009;132
1992;17;57,277261;9,94587;1986;2021;35
1992;35;55,3225039;11,9608428;1920;2010;90
1992;38;55,973541;12,534777;1946;2021;75
1992;46;57,623216;10,430582;1985;2011;26
1992;50;55,8569401;12,0706508;1985;2010;25
1992;55;55,242371;10,53961;1866;2021;155
1992;64;54,689732;11,964726;1971;2021;50
1992;69;55,182844;9,45901;1920;2004;84
1992;72;55,7038449;10,0061417;1977;1996;19
1992;73;55,84433;9,589121;1848;2021;173
1992;77;56,028439;12,589834;1921;2021;100
1992;78;55,9895282;12,5557539;1979;1993;14
1992;79;56,051014;12,584655;1969;2008;39
1992;84;55,952225;8,782211;1986;2006;20
1992;87;55,941434;12,268503;1937;2021;84
1992;88;55,944946;12,309925;1923;2021;98
1992;91;57,585341;9,980745;1983;2004;21
1992;93;57,356497;9,936222;1890;2021;131
1992;95;55,704063;11,690361;1963;2021;58
1992;101;56,257646;8,279111;1971;1996;25
1992;102;56,359714;8,597986;1973;2004;31
1992;104;55,92122;9,997713;1979;2000;21
1992;110;55,965642;9,717756;1884;2006;122
1992;131;55,46168;10,663878;1952;2005;53
1992;133;55,4967868;9,4924387;1983;2001;18
1992;135;55,482156;9,451854;1949;2021;72
1992;144;55,673798;12,577517;1891;2021;130
1992;145;55,682456;12,569828;1877;2021;144
1992;156;56,546487;8,414392;1971;2021;50
1992;158;54,815811;11,264489;1905;1996;91
1992;159;54,797991;11,516179;1986;2001;15
1992;165;56,6472378;9,970264;1954;2021;67
1992;169;55,490971;9,972686;1986;2021;35
1992;186;55,568493;10,097624;1985;1996;11
1992;194;55,92104;10,25164;1956;2021;65
1992;195;55,9775064;10,1756177;1890;2021;131
1992;196;55,991623;10,251408;1972;2015;43
1992;204;55,837896;11,551628;1991;2021;30
1992;207;55,960508;11,749297;1980;2015;35
1992;215;56,886164;9,836899;1886;2009;123
1992;217;56,06639;8,314841;1969;2021;52
1992;218;55,512414;11,688584;1991;2000;9
1992;225;55,801472;10,556744;1984;2012;28
1992;230;56,178325;9,590822;1971;2021;50
1992;236;56,090396;9,758625;1892;2021;129
1992;238;56,545839;9,028644;1991;1992;1
1992;239;56,572888;9,051158;1907;2021;114
1992;248;55,2506641;11,274915;1973;2005;32
1992;255;55,058636;10,606186;1972;1997;25
1992;256;55,070962;10,511664;1920;2021;101
1992;258;55,1225643;10,7284368;1989;2021;32
1992;270;56,302138;10,477471;1894;2021;127
1992;271;54,986632;9,977204;1920;2002;82
1992;273;54,898325;9,802925;1952;2021;69
1992;283;55,054318;8,950471;1960;2021;61
1992;285;55,1913926;9,066302;1984;2021;37
1992;294;55,471013;9,099652;1865;2021;156
1992;301;55,643464;9,651961;1889;2021;132
1992;302;55,715222;9,319221;1940;2021;81
1992;307;55,716877;9,585268;1943;2021;78
1992;312;56,411417;9,346793;1992;1993;1
1992;314;56,377182;9,64424;1972;2021;49
1992;315;56,552152;9,40118;1868;2021;153
1992;316;56,441433;9,422904;1951;2021;70
1992;322;54,9748134;12,2737822;1866;2021;155
1992;324;54,924137;10,278204;1985;2021;36
1992;325;54,889128;10,412794;1978;2011;33
1992;328;54,873518;9,518945;1921;2021;100
1992;336;56,032176;10,125522;1869;2005;136
1992;339;56,214752;10,27358;1970;2021;51
1992;342;56,1956788;10,2204946;1970;2021;51
1992;343;56,101781;10,070482;1971;2011;40
1992;346;56,067076;10,134812;1866;2021;155
1992;13;55,18902;14,96054;1867;2021;154
1992;23;55,48022;8,43888;1910;2012;102
1992;26;55,28979;8,68128;1970;2021;51
1992;29;56,328077;10,04661;1876;2021;145
1992;37;55,91688;12,42258;1987;1996;9
1992;82;56,13374;9,0217;1960;2007;47
1992;83;56,08339;8,98743;1972;2021;49
1992;100;56,25765;8,27911;1985;1996;11
1992;117;55,87377;12,4726;1974;1994;20
1992;130;55,67057;11,18151;1899;2021;122
1992;134;55,43241;9,3068;1979;1996;17
1992;136;55,50785;9,47085;1972;1998;26
1992;149;54,77112;10,71543;1984;2001;17
1992;170;55,50629;9,75098;1964;2001;37
1992;171;55,48663;9,86367;1959;2008;49
1992;208;55,74166;11,41925;1865;2021;156
1992;219;55,66464;12,09277;1930;2001;71
1992;245;55,35164;11,32714;1938;2021;83
1992;272;54,89137;9,8371;1983;2001;18
1992;276;56,95147;8,58714;1982;2000;18
1992;286;55,01112;8,78377;1979;1994;15
1992;291;55,78719;8,25611;1985;2007;22
1992;298;55,4843;9,12621;1981;1993;12
1992;299;55,77169;9,47224;1960;2021;61
1992;309;56,76125;9,23757;1981;1998;17
1992;329;54,96651;9,30635;1977;1995;18
1992;335;57,04003;10,01645;1982;2021;39
1992;337;56,13962;10,20498;1928;2004;76
1993;3;55,412663;10,12987;1970;2011;41
1993;6;55,269626;10,11524;1877;2009;132
1993;17;57,277261;9,94587;1986;2021;35
1993;35;55,3225039;11,9608428;1920;2010;90
1993;38;55,973541;12,534777;1946;2021;75
1993;46;57,623216;10,430582;1985;2011;26
1993;50;55,8569401;12,0706508;1985;2010;25
1993;55;55,242371;10,53961;1866;2021;155
1993;64;54,689732;11,964726;1971;2021;50
1993;69;55,182844;9,45901;1920;2004;84
1993;72;55,7038449;10,0061417;1977;1996;19
1993;73;55,84433;9,589121;1848;2021;173
1993;77;56,028439;12,589834;1921;2021;100
1993;78;55,9895282;12,5557539;1979;1993;14
1993;79;56,051014;12,584655;1969;2008;39
1993;84;55,952225;8,782211;1986;2006;20
1993;87;55,941434;12,268503;1937;2021;84
1993;88;55,944946;12,309925;1923;2021;98
1993;91;57,585341;9,980745;1983;2004;21
1993;93;57,356497;9,936222;1890;2021;131
1993;95;55,704063;11,690361;1963;2021;58
1993;101;56,257646;8,279111;1971;1996;25
1993;102;56,359714;8,597986;1973;2004;31
1993;104;55,92122;9,997713;1979;2000;21
1993;110;55,965642;9,717756;1884;2006;122
1993;119;55,9551036;9,1145709;1993;2002;9
1993;121;55,9653067;9,094499;1993;2021;28
1993;131;55,46168;10,663878;1952;2005;53
1993;133;55,4967868;9,4924387;1983;2001;18
1993;135;55,482156;9,451854;1949;2021;72
1993;144;55,673798;12,577517;1891;2021;130
1993;145;55,682456;12,569828;1877;2021;144
1993;156;56,546487;8,414392;1971;2021;50
1993;158;54,815811;11,264489;1905;1996;91
1993;159;54,797991;11,516179;1986;2001;15
1993;165;56,6472378;9,970264;1954;2021;67
1993;169;55,490971;9,972686;1986;2021;35
1993;186;55,568493;10,097624;1985;1996;11
1993;194;55,92104;10,25164;1956;2021;65
1993;195;55,9775064;10,1756177;1890;2021;131
1993;196;55,991623;10,251408;1972;2015;43
1993;204;55,837896;11,551628;1991;2021;30
1993;207;55,960508;11,749297;1980;2015;35
1993;215;56,886164;9,836899;1886;2009;123
1993;217;56,06639;8,314841;1969;2021;52
1993;218;55,512414;11,688584;1991;2000;9
1993;225;55,801472;10,556744;1984;2012;28
1993;230;56,178325;9,590822;1971;2021;50
1993;236;56,090396;9,758625;1892;2021;129
1993;237;56,545839;9,028644;1993;1993;0
1993;239;56,572888;9,051158;1907;2021;114
1993;248;55,2506641;11,274915;1973;2005;32
1993;255;55,058636;10,606186;1972;1997;25
1993;256;55,070962;10,511664;1920;2021;101
1993;258;55,1225643;10,7284368;1989;2021;32
1993;262;56,193792;10,691846;1993;2021;28
1993;270;56,302138;10,477471;1894;2021;127
1993;271;54,986632;9,977204;1920;2002;82
1993;273;54,898325;9,802925;1952;2021;69
1993;283;55,054318;8,950471;1960;2021;61
1993;285;55,1913926;9,066302;1984;2021;37
1993;294;55,471013;9,099652;1865;2021;156
1993;301;55,643464;9,651961;1889;2021;132
1993;302;55,715222;9,319221;1940;2021;81
1993;307;55,716877;9,585268;1943;2021;78
1993;312;56,411417;9,346793;1992;1993;1
1993;314;56,377182;9,64424;1972;2021;49
1993;315;56,552152;9,40118;1868;2021;153
1993;316;56,441433;9,422904;1951;2021;70
1993;322;54,9748134;12,2737822;1866;2021;155
1993;324;54,924137;10,278204;1985;2021;36
1993;325;54,889128;10,412794;1978;2011;33
1993;327;55,030253;9,419819;1993;2020;27
1993;328;54,873518;9,518945;1921;2021;100
1993;336;56,032176;10,125522;1869;2005;136
1993;339;56,214752;10,27358;1970;2021;51
1993;342;56,1956788;10,2204946;1970;2021;51
1993;343;56,101781;10,070482;1971;2011;40
1993;346;56,067076;10,134812;1866;2021;155
1993;13;55,18902;14,96054;1867;2021;154
1993;23;55,48022;8,43888;1910;2012;102
1993;26;55,28979;8,68128;1970;2021;51
1993;29;56,328077;10,04661;1876;2021;145
1993;37;55,91688;12,42258;1987;1996;9
1993;82;56,13374;9,0217;1960;2007;47
1993;83;56,08339;8,98743;1972;2021;49
1993;100;56,25765;8,27911;1985;1996;11
1993;117;55,87377;12,4726;1974;1994;20
1993;130;55,67057;11,18151;1899;2021;122
1993;134;55,43241;9,3068;1979;1996;17
1993;136;55,50785;9,47085;1972;1998;26
1993;149;54,77112;10,71543;1984;2001;17
1993;170;55,50629;9,75098;1964;2001;37
1993;171;55,48663;9,86367;1959;2008;49
1993;206;55,94836;11,59794;1993;2000;7
1993;208;55,74166;11,41925;1865;2021;156
1993;219;55,66464;12,09277;1930;2001;71
1993;245;55,35164;11,32714;1938;2021;83
1993;272;54,89137;9,8371;1983;2001;18
1993;276;56,95147;8,58714;1982;2000;18
1993;286;55,01112;8,78377;1979;1994;15
1993;291;55,78719;8,25611;1985;2007;22
1993;298;55,4843;9,12621;1981;1993;12
1993;299;55,77169;9,47224;1960;2021;61
1993;309;56,76125;9,23757;1981;1998;17
1993;329;54,96651;9,30635;1977;1995;18
1993;335;57,04003;10,01645;1982;2021;39
1993;337;56,13962;10,20498;1928;2004;76
1994;3;55,412663;10,12987;1970;2011;41
1994;6;55,269626;10,11524;1877;2009;132
1994;17;57,277261;9,94587;1986;2021;35
1994;35;55,3225039;11,9608428;1920;2010;90
1994;38;55,973541;12,534777;1946;2021;75
1994;46;57,623216;10,430582;1985;2011;26
1994;50;55,8569401;12,0706508;1985;2010;25
1994;55;55,242371;10,53961;1866;2021;155
1994;64;54,689732;11,964726;1971;2021;50
1994;69;55,182844;9,45901;1920;2004;84
1994;72;55,7038449;10,0061417;1977;1996;19
1994;73;55,84433;9,589121;1848;2021;173
1994;77;56,028439;12,589834;1921;2021;100
1994;79;56,051014;12,584655;1969;2008;39
1994;84;55,952225;8,782211;1986;2006;20
1994;87;55,941434;12,268503;1937;2021;84
1994;88;55,944946;12,309925;1923;2021;98
1994;91;57,585341;9,980745;1983;2004;21
1994;93;57,356497;9,936222;1890;2021;131
1994;95;55,704063;11,690361;1963;2021;58
1994;97;55,659832;11,393806;1994;1995;1
1994;101;56,257646;8,279111;1971;1996;25
1994;102;56,359714;8,597986;1973;2004;31
1994;104;55,92122;9,997713;1979;2000;21
1994;110;55,965642;9,717756;1884;2006;122
1994;119;55,9551036;9,1145709;1993;2002;9
1994;121;55,9653067;9,094499;1993;2021;28
1994;122;56,148673;9,142385;1994;2021;27
1994;131;55,46168;10,663878;1952;2005;53
1994;133;55,4967868;9,4924387;1983;2001;18
1994;135;55,482156;9,451854;1949;2021;72
1994;144;55,673798;12,577517;1891;2021;130
1994;145;55,682456;12,569828;1877;2021;144
1994;156;56,546487;8,414392;1971;2021;50
1994;158;54,815811;11,264489;1905;1996;91
1994;159;54,797991;11,516179;1986;2001;15
1994;165;56,6472378;9,970264;1954;2021;67
1994;169;55,490971;9,972686;1986;2021;35
1994;186;55,568493;10,097624;1985;1996;11
1994;194;55,92104;10,25164;1956;2021;65
1994;195;55,9775064;10,1756177;1890;2021;131
1994;196;55,991623;10,251408;1972;2015;43
1994;204;55,837896;11,551628;1991;2021;30
1994;207;55,960508;11,749297;1980;2015;35
1994;215;56,886164;9,836899;1886;2009;123
1994;217;56,06639;8,314841;1969;2021;52
1994;218;55,512414;11,688584;1991;2000;9
1994;225;55,801472;10,556744;1984;2012;28
1994;230;56,178325;9,590822;1971;2021;50
1994;236;56,090396;9,758625;1892;2021;129
1994;239;56,572888;9,051158;1907;2021;114
1994;248;55,2506641;11,274915;1973;2005;32
1994;255;55,058636;10,606186;1972;1997;25
1994;256;55,070962;10,511664;1920;2021;101
1994;258;55,1225643;10,7284368;1989;2021;32
1994;262;56,193792;10,691846;1993;2021;28
1994;270;56,302138;10,477471;1894;2021;127
1994;271;54,986632;9,977204;1920;2002;82
1994;273;54,898325;9,802925;1952;2021;69
1994;283;55,054318;8,950471;1960;2021;61
1994;285;55,1913926;9,066302;1984;2021;37
1994;294;55,471013;9,099652;1865;2021;156
1994;301;55,643464;9,651961;1889;2021;132
1994;302;55,715222;9,319221;1940;2021;81
1994;307;55,716877;9,585268;1943;2021;78
1994;314;56,377182;9,64424;1972;2021;49
1994;315;56,552152;9,40118;1868;2021;153
1994;316;56,441433;9,422904;1951;2021;70
1994;322;54,9748134;12,2737822;1866;2021;155
1994;324;54,924137;10,278204;1985;2021;36
1994;325;54,889128;10,412794;1978;2011;33
1994;327;55,030253;9,419819;1993;2020;27
1994;328;54,873518;9,518945;1921;2021;100
1994;336;56,032176;10,125522;1869;2005;136
1994;339;56,214752;10,27358;1970;2021;51
1994;342;56,1956788;10,2204946;1970;2021;51
1994;343;56,101781;10,070482;1971;2011;40
1994;346;56,067076;10,134812;1866;2021;155
1994;13;55,18902;14,96054;1867;2021;154
1994;23;55,48022;8,43888;1910;2012;102
1994;26;55,28979;8,68128;1970;2021;51
1994;29;56,328077;10,04661;1876;2021;145
1994;37;55,91688;12,42258;1987;1996;9
1994;82;56,13374;9,0217;1960;2007;47
1994;83;56,08339;8,98743;1972;2021;49
1994;100;56,25765;8,27911;1985;1996;11
1994;113;55,87377;12,4726;1994;1996;2
1994;117;55,87377;12,4726;1974;1994;20
1994;130;55,67057;11,18151;1899;2021;122
1994;134;55,43241;9,3068;1979;1996;17
1994;136;55,50785;9,47085;1972;1998;26
1994;149;54,77112;10,71543;1984;2001;17
1994;170;55,50629;9,75098;1964;2001;37
1994;171;55,48663;9,86367;1959;2008;49
1994;206;55,94836;11,59794;1993;2000;7
1994;208;55,74166;11,41925;1865;2021;156
1994;219;55,66464;12,09277;1930;2001;71
1994;245;55,35164;11,32714;1938;2021;83
1994;272;54,89137;9,8371;1983;2001;18
1994;276;56,95147;8,58714;1982;2000;18
1994;286;55,01112;8,78377;1979;1994;15
1994;291;55,78719;8,25611;1985;2007;22
1994;299;55,77169;9,47224;1960;2021;61
1994;309;56,76125;9,23757;1981;1998;17
1994;329;54,96651;9,30635;1977;1995;18
1994;335;57,04003;10,01645;1982;2021;39
1994;337;56,13962;10,20498;1928;2004;76
1995;3;55,412663;10,12987;1970;2011;41
1995;5;55,146277;10,020784;1995;2012;17
1995;6;55,269626;10,11524;1877;2009;132
1995;17;57,277261;9,94587;1986;2021;35
1995;35;55,3225039;11,9608428;1920;2010;90
1995;38;55,973541;12,534777;1946;2021;75
1995;46;57,623216;10,430582;1985;2011;26
1995;50;55,8569401;12,0706508;1985;2010;25
1995;55;55,242371;10,53961;1866;2021;155
1995;64;54,689732;11,964726;1971;2021;50
1995;69;55,182844;9,45901;1920;2004;84
1995;72;55,7038449;10,0061417;1977;1996;19
1995;73;55,84433;9,589121;1848;2021;173
1995;77;56,028439;12,589834;1921;2021;100
1995;79;56,051014;12,584655;1969;2008;39
1995;84;55,952225;8,782211;1986;2006;20
1995;87;55,941434;12,268503;1937;2021;84
1995;88;55,944946;12,309925;1923;2021;98
1995;91;57,585341;9,980745;1983;2004;21
1995;93;57,356497;9,936222;1890;2021;131
1995;95;55,704063;11,690361;1963;2021;58
1995;97;55,659832;11,393806;1994;1995;1
1995;101;56,257646;8,279111;1971;1996;25
1995;102;56,359714;8,597986;1973;2004;31
1995;104;55,92122;9,997713;1979;2000;21
1995;110;55,965642;9,717756;1884;2006;122
1995;119;55,9551036;9,1145709;1993;2002;9
1995;121;55,9653067;9,094499;1993;2021;28
1995;122;56,148673;9,142385;1994;2021;27
1995;131;55,46168;10,663878;1952;2005;53
1995;133;55,4967868;9,4924387;1983;2001;18
1995;135;55,482156;9,451854;1949;2021;72
1995;144;55,673798;12,577517;1891;2021;130
1995;145;55,682456;12,569828;1877;2021;144
1995;156;56,546487;8,414392;1971;2021;50
1995;158;54,815811;11,264489;1905;1996;91
1995;159;54,797991;11,516179;1986;2001;15
1995;165;56,6472378;9,970264;1954;2021;67
1995;169;55,490971;9,972686;1986;2021;35
1995;186;55,568493;10,097624;1985;1996;11
1995;194;55,92104;10,25164;1956;2021;65
1995;195;55,9775064;10,1756177;1890;2021;131
1995;196;55,991623;10,251408;1972;2015;43
1995;204;55,837896;11,551628;1991;2021;30
1995;207;55,960508;11,749297;1980;2015;35
1995;215;56,886164;9,836899;1886;2009;123
1995;217;56,06639;8,314841;1969;2021;52
1995;218;55,512414;11,688584;1991;2000;9
1995;225;55,801472;10,556744;1984;2012;28
1995;230;56,178325;9,590822;1971;2021;50
1995;236;56,090396;9,758625;1892;2021;129
1995;239;56,572888;9,051158;1907;2021;114
1995;248;55,2506641;11,274915;1973;2005;32
1995;255;55,058636;10,606186;1972;1997;25
1995;256;55,070962;10,511664;1920;2021;101
1995;258;55,1225643;10,7284368;1989;2021;32
1995;262;56,193792;10,691846;1993;2021;28
1995;270;56,302138;10,477471;1894;2021;127
1995;271;54,986632;9,977204;1920;2002;82
1995;273;54,898325;9,802925;1952;2021;69
1995;283;55,054318;8,950471;1960;2021;61
1995;285;55,1913926;9,066302;1984;2021;37
1995;294;55,471013;9,099652;1865;2021;156
1995;301;55,643464;9,651961;1889;2021;132
1995;302;55,715222;9,319221;1940;2021;81
1995;307;55,716877;9,585268;1943;2021;78
1995;314;56,377182;9,64424;1972;2021;49
1995;315;56,552152;9,40118;1868;2021;153
1995;316;56,441433;9,422904;1951;2021;70
1995;322;54,9748134;12,2737822;1866;2021;155
1995;324;54,924137;10,278204;1985;2021;36
1995;325;54,889128;10,412794;1978;2011;33
1995;327;55,030253;9,419819;1993;2020;27
1995;328;54,873518;9,518945;1921;2021;100
1995;336;56,032176;10,125522;1869;2005;136
1995;339;56,214752;10,27358;1970;2021;51
1995;342;56,1956788;10,2204946;1970;2021;51
1995;343;56,101781;10,070482;1971;2011;40
1995;346;56,067076;10,134812;1866;2021;155
1995;13;55,18902;14,96054;1867;2021;154
1995;23;55,48022;8,43888;1910;2012;102
1995;26;55,28979;8,68128;1970;2021;51
1995;29;56,328077;10,04661;1876;2021;145
1995;37;55,91688;12,42258;1987;1996;9
1995;82;56,13374;9,0217;1960;2007;47
1995;83;56,08339;8,98743;1972;2021;49
1995;100;56,25765;8,27911;1985;1996;11
1995;113;55,87377;12,4726;1994;1996;2
1995;130;55,67057;11,18151;1899;2021;122
1995;134;55,43241;9,3068;1979;1996;17
1995;136;55,50785;9,47085;1972;1998;26
1995;149;54,77112;10,71543;1984;2001;17
1995;170;55,50629;9,75098;1964;2001;37
1995;171;55,48663;9,86367;1959;2008;49
1995;206;55,94836;11,59794;1993;2000;7
1995;208;55,74166;11,41925;1865;2021;156
1995;219;55,66464;12,09277;1930;2001;71
1995;245;55,35164;11,32714;1938;2021;83
1995;272;54,89137;9,8371;1983;2001;18
1995;276;56,95147;8,58714;1982;2000;18
1995;291;55,78719;8,25611;1985;2007;22
1995;299;55,77169;9,47224;1960;2021;61
1995;309;56,76125;9,23757;1981;1998;17
1995;329;54,96651;9,30635;1977;1995;18
1995;335;57,04003;10,01645;1982;2021;39
1995;337;56,13962;10,20498;1928;2004;76
1996;3;55,412663;10,12987;1970;2011;41
1996;5;55,146277;10,020784;1995;2012;17
1996;6;55,269626;10,11524;1877;2009;132
1996;17;57,277261;9,94587;1986;2021;35
1996;35;55,3225039;11,9608428;1920;2010;90
1996;38;55,973541;12,534777;1946;2021;75
1996;46;57,623216;10,430582;1985;2011;26
1996;50;55,8569401;12,0706508;1985;2010;25
1996;55;55,242371;10,53961;1866;2021;155
1996;64;54,689732;11,964726;1971;2021;50
1996;69;55,182844;9,45901;1920;2004;84
1996;72;55,7038449;10,0061417;1977;1996;19
1996;73;55,84433;9,589121;1848;2021;173
1996;77;56,028439;12,589834;1921;2021;100
1996;79;56,051014;12,584655;1969;2008;39
1996;84;55,952225;8,782211;1986;2006;20
1996;87;55,941434;12,268503;1937;2021;84
1996;88;55,944946;12,309925;1923;2021;98
1996;91;57,585341;9,980745;1983;2004;21
1996;93;57,356497;9,936222;1890;2021;131
1996;95;55,704063;11,690361;1963;2021;58
1996;101;56,257646;8,279111;1971;1996;25
1996;102;56,359714;8,597986;1973;2004;31
1996;104;55,92122;9,997713;1979;2000;21
1996;110;55,965642;9,717756;1884;2006;122
1996;119;55,9551036;9,1145709;1993;2002;9
1996;121;55,9653067;9,094499;1993;2021;28
1996;122;56,148673;9,142385;1994;2021;27
1996;131;55,46168;10,663878;1952;2005;53
1996;133;55,4967868;9,4924387;1983;2001;18
1996;135;55,482156;9,451854;1949;2021;72
1996;144;55,673798;12,577517;1891;2021;130
1996;145;55,682456;12,569828;1877;2021;144
1996;156;56,546487;8,414392;1971;2021;50
1996;158;54,815811;11,264489;1905;1996;91
1996;159;54,797991;11,516179;1986;2001;15
1996;165;56,6472378;9,970264;1954;2021;67
1996;169;55,490971;9,972686;1986;2021;35
1996;183;56,410263;10,747305;1996;2015;19
1996;186;55,568493;10,097624;1985;1996;11
1996;194;55,92104;10,25164;1956;2021;65
1996;195;55,9775064;10,1756177;1890;2021;131
1996;196;55,991623;10,251408;1972;2015;43
1996;204;55,837896;11,551628;1991;2021;30
1996;207;55,960508;11,749297;1980;2015;35
1996;215;56,886164;9,836899;1886;2009;123
1996;217;56,06639;8,314841;1969;2021;52
1996;218;55,512414;11,688584;1991;2000;9
1996;225;55,801472;10,556744;1984;2012;28
1996;230;56,178325;9,590822;1971;2021;50
1996;236;56,090396;9,758625;1892;2021;129
1996;239;56,572888;9,051158;1907;2021;114
1996;248;55,2506641;11,274915;1973;2005;32
1996;255;55,058636;10,606186;1972;1997;25
1996;256;55,070962;10,511664;1920;2021;101
1996;258;55,1225643;10,7284368;1989;2021;32
1996;262;56,193792;10,691846;1993;2021;28
1996;270;56,302138;10,477471;1894;2021;127
1996;271;54,986632;9,977204;1920;2002;82
1996;273;54,898325;9,802925;1952;2021;69
1996;283;55,054318;8,950471;1960;2021;61
1996;285;55,1913926;9,066302;1984;2021;37
1996;294;55,471013;9,099652;1865;2021;156
1996;301;55,643464;9,651961;1889;2021;132
1996;302;55,715222;9,319221;1940;2021;81
1996;307;55,716877;9,585268;1943;2021;78
1996;314;56,377182;9,64424;1972;2021;49
1996;315;56,552152;9,40118;1868;2021;153
1996;316;56,441433;9,422904;1951;2021;70
1996;322;54,9748134;12,2737822;1866;2021;155
1996;324;54,924137;10,278204;1985;2021;36
1996;325;54,889128;10,412794;1978;2011;33
1996;327;55,030253;9,419819;1993;2020;27
1996;328;54,873518;9,518945;1921;2021;100
1996;336;56,032176;10,125522;1869;2005;136
1996;339;56,214752;10,27358;1970;2021;51
1996;342;56,1956788;10,2204946;1970;2021;51
1996;343;56,101781;10,070482;1971;2011;40
1996;346;56,067076;10,134812;1866;2021;155
1996;13;55,18902;14,96054;1867;2021;154
1996;23;55,48022;8,43888;1910;2012;102
1996;26;55,28979;8,68128;1970;2021;51
1996;29;56,328077;10,04661;1876;2021;145
1996;37;55,91688;12,42258;1987;1996;9
1996;82;56,13374;9,0217;1960;2007;47
1996;83;56,08339;8,98743;1972;2021;49
1996;100;56,25765;8,27911;1985;1996;11
1996;113;55,87377;12,4726;1994;1996;2
1996;130;55,67057;11,18151;1899;2021;122
1996;134;55,43241;9,3068;1979;1996;17
1996;136;55,50785;9,47085;1972;1998;26
1996;149;54,77112;10,71543;1984;2001;17
1996;170;55,50629;9,75098;1964;2001;37
1996;171;55,48663;9,86367;1959;2008;49
1996;206;55,94836;11,59794;1993;2000;7
1996;208;55,74166;11,41925;1865;2021;156
1996;219;55,66464;12,09277;1930;2001;71
1996;245;55,35164;11,32714;1938;2021;83
1996;272;54,89137;9,8371;1983;2001;18
1996;276;56,95147;8,58714;1982;2000;18
1996;291;55,78719;8,25611;1985;2007;22
1996;299;55,77169;9,47224;1960;2021;61
1996;309;56,76125;9,23757;1981;1998;17
1996;335;57,04003;10,01645;1982;2021;39
1996;337;56,13962;10,20498;1928;2004;76
1997;3;55,412663;10,12987;1970;2011;41
1997;5;55,146277;10,020784;1995;2012;17
1997;6;55,269626;10,11524;1877;2009;132
1997;17;57,277261;9,94587;1986;2021;35
1997;35;55,3225039;11,9608428;1920;2010;90
1997;38;55,973541;12,534777;1946;2021;75
1997;46;57,623216;10,430582;1985;2011;26
1997;50;55,8569401;12,0706508;1985;2010;25
1997;55;55,242371;10,53961;1866;2021;155
1997;64;54,689732;11,964726;1971;2021;50
1997;69;55,182844;9,45901;1920;2004;84
1997;73;55,84433;9,589121;1848;2021;173
1997;77;56,028439;12,589834;1921;2021;100
1997;79;56,051014;12,584655;1969;2008;39
1997;84;55,952225;8,782211;1986;2006;20
1997;87;55,941434;12,268503;1937;2021;84
1997;88;55,944946;12,309925;1923;2021;98
1997;91;57,585341;9,980745;1983;2004;21
1997;93;57,356497;9,936222;1890;2021;131
1997;95;55,704063;11,690361;1963;2021;58
1997;99;55,61259;11,745544;1997;1998;1
1997;102;56,359714;8,597986;1973;2004;31
1997;104;55,92122;9,997713;1979;2000;21
1997;110;55,965642;9,717756;1884;2006;122
1997;119;55,9551036;9,1145709;1993;2002;9
1997;121;55,9653067;9,094499;1993;2021;28
1997;122;56,148673;9,142385;1994;2021;27
1997;131;55,46168;10,663878;1952;2005;53
1997;133;55,4967868;9,4924387;1983;2001;18
1997;135;55,482156;9,451854;1949;2021;72
1997;144;55,673798;12,577517;1891;2021;130
1997;145;55,682456;12,569828;1877;2021;144
1997;156;56,546487;8,414392;1971;2021;50
1997;159;54,797991;11,516179;1986;2001;15
1997;165;56,6472378;9,970264;1954;2021;67
1997;169;55,490971;9,972686;1986;2021;35
1997;183;56,410263;10,747305;1996;2015;19
1997;194;55,92104;10,25164;1956;2021;65
1997;195;55,9775064;10,1756177;1890;2021;131
1997;196;55,991623;10,251408;1972;2015;43
1997;204;55,837896;11,551628;1991;2021;30
1997;207;55,960508;11,749297;1980;2015;35
1997;215;56,886164;9,836899;1886;2009;123
1997;217;56,06639;8,314841;1969;2021;52
1997;218;55,512414;11,688584;1991;2000;9
1997;225;55,801472;10,556744;1984;2012;28
1997;230;56,178325;9,590822;1971;2021;50
1997;236;56,090396;9,758625;1892;2021;129
1997;239;56,572888;9,051158;1907;2021;114
1997;248;55,2506641;11,274915;1973;2005;32
1997;255;55,058636;10,606186;1972;1997;25
1997;256;55,070962;10,511664;1920;2021;101
1997;258;55,1225643;10,7284368;1989;2021;32
1997;262;56,193792;10,691846;1993;2021;28
1997;270;56,302138;10,477471;1894;2021;127
1997;271;54,986632;9,977204;1920;2002;82
1997;273;54,898325;9,802925;1952;2021;69
1997;283;55,054318;8,950471;1960;2021;61
1997;285;55,1913926;9,066302;1984;2021;37
1997;294;55,471013;9,099652;1865;2021;156
1997;301;55,643464;9,651961;1889;2021;132
1997;302;55,715222;9,319221;1940;2021;81
1997;307;55,716877;9,585268;1943;2021;78
1997;314;56,377182;9,64424;1972;2021;49
1997;315;56,552152;9,40118;1868;2021;153
1997;316;56,441433;9,422904;1951;2021;70
1997;322;54,9748134;12,2737822;1866;2021;155
1997;324;54,924137;10,278204;1985;2021;36
1997;325;54,889128;10,412794;1978;2011;33
1997;327;55,030253;9,419819;1993;2020;27
1997;328;54,873518;9,518945;1921;2021;100
1997;336;56,032176;10,125522;1869;2005;136
1997;339;56,214752;10,27358;1970;2021;51
1997;342;56,1956788;10,2204946;1970;2021;51
1997;343;56,101781;10,070482;1971;2011;40
1997;346;56,067076;10,134812;1866;2021;155
1997;13;55,18902;14,96054;1867;2021;154
1997;23;55,48022;8,43888;1910;2012;102
1997;26;55,28979;8,68128;1970;2021;51
1997;29;56,328077;10,04661;1876;2021;145
1997;82;56,13374;9,0217;1960;2007;47
1997;83;56,08339;8,98743;1972;2021;49
1997;130;55,67057;11,18151;1899;2021;122
1997;136;55,50785;9,47085;1972;1998;26
1997;149;54,77112;10,71543;1984;2001;17
1997;170;55,50629;9,75098;1964;2001;37
1997;171;55,48663;9,86367;1959;2008;49
1997;206;55,94836;11,59794;1993;2000;7
1997;208;55,74166;11,41925;1865;2021;156
1997;219;55,66464;12,09277;1930;2001;71
1997;245;55,35164;11,32714;1938;2021;83
1997;272;54,89137;9,8371;1983;2001;18
1997;276;56,95147;8,58714;1982;2000;18
1997;291;55,78719;8,25611;1985;2007;22
1997;299;55,77169;9,47224;1960;2021;61
1997;309;56,76125;9,23757;1981;1998;17
1997;335;57,04003;10,01645;1982;2021;39
1997;337;56,13962;10,20498;1928;2004;76
1998;3;55,412663;10,12987;1970;2011;41
1998;5;55,146277;10,020784;1995;2012;17
1998;6;55,269626;10,11524;1877;2009;132
1998;17;57,277261;9,94587;1986;2021;35
1998;35;55,3225039;11,9608428;1920;2010;90
1998;38;55,973541;12,534777;1946;2021;75
1998;46;57,623216;10,430582;1985;2011;26
1998;50;55,8569401;12,0706508;1985;2010;25
1998;55;55,242371;10,53961;1866;2021;155
1998;64;54,689732;11,964726;1971;2021;50
1998;69;55,182844;9,45901;1920;2004;84
1998;73;55,84433;9,589121;1848;2021;173
1998;77;56,028439;12,589834;1921;2021;100
1998;79;56,051014;12,584655;1969;2008;39
1998;84;55,952225;8,782211;1986;2006;20
1998;87;55,941434;12,268503;1937;2021;84
1998;88;55,944946;12,309925;1923;2021;98
1998;91;57,585341;9,980745;1983;2004;21
1998;93;57,356497;9,936222;1890;2021;131
1998;95;55,704063;11,690361;1963;2021;58
1998;99;55,61259;11,745544;1997;1998;1
1998;102;56,359714;8,597986;1973;2004;31
1998;104;55,92122;9,997713;1979;2000;21
1998;110;55,965642;9,717756;1884;2006;122
1998;119;55,9551036;9,1145709;1993;2002;9
1998;121;55,9653067;9,094499;1993;2021;28
1998;122;56,148673;9,142385;1994;2021;27
1998;131;55,46168;10,663878;1952;2005;53
1998;133;55,4967868;9,4924387;1983;2001;18
1998;135;55,482156;9,451854;1949;2021;72
1998;144;55,673798;12,577517;1891;2021;130
1998;145;55,682456;12,569828;1877;2021;144
1998;156;56,546487;8,414392;1971;2021;50
1998;159;54,797991;11,516179;1986;2001;15
1998;165;56,6472378;9,970264;1954;2021;67
1998;169;55,490971;9,972686;1986;2021;35
1998;183;56,410263;10,747305;1996;2015;19
1998;185;55,548046;10,108677;1998;1999;1
1998;194;55,92104;10,25164;1956;2021;65
1998;195;55,9775064;10,1756177;1890;2021;131
1998;196;55,991623;10,251408;1972;2015;43
1998;204;55,837896;11,551628;1991;2021;30
1998;207;55,960508;11,749297;1980;2015;35
1998;215;56,886164;9,836899;1886;2009;123
1998;217;56,06639;8,314841;1969;2021;52
1998;218;55,512414;11,688584;1991;2000;9
1998;225;55,801472;10,556744;1984;2012;28
1998;230;56,178325;9,590822;1971;2021;50
1998;236;56,090396;9,758625;1892;2021;129
1998;239;56,572888;9,051158;1907;2021;114
1998;248;55,2506641;11,274915;1973;2005;32
1998;256;55,070962;10,511664;1920;2021;101
1998;258;55,1225643;10,7284368;1989;2021;32
1998;262;56,193792;10,691846;1993;2021;28
1998;270;56,302138;10,477471;1894;2021;127
1998;271;54,986632;9,977204;1920;2002;82
1998;273;54,898325;9,802925;1952;2021;69
1998;283;55,054318;8,950471;1960;2021;61
1998;285;55,1913926;9,066302;1984;2021;37
1998;294;55,471013;9,099652;1865;2021;156
1998;301;55,643464;9,651961;1889;2021;132
1998;302;55,715222;9,319221;1940;2021;81
1998;307;55,716877;9,585268;1943;2021;78
1998;314;56,377182;9,64424;1972;2021;49
1998;315;56,552152;9,40118;1868;2021;153
1998;316;56,441433;9,422904;1951;2021;70
1998;322;54,9748134;12,2737822;1866;2021;155
1998;324;54,924137;10,278204;1985;2021;36
1998;325;54,889128;10,412794;1978;2011;33
1998;327;55,030253;9,419819;1993;2020;27
1998;328;54,873518;9,518945;1921;2021;100
1998;336;56,032176;10,125522;1869;2005;136
1998;339;56,214752;10,27358;1970;2021;51
1998;342;56,1956788;10,2204946;1970;2021;51
1998;343;56,101781;10,070482;1971;2011;40
1998;346;56,067076;10,134812;1866;2021;155
1998;13;55,18902;14,96054;1867;2021;154
1998;23;55,48022;8,43888;1910;2012;102
1998;26;55,28979;8,68128;1970;2021;51
1998;29;56,328077;10,04661;1876;2021;145
1998;82;56,13374;9,0217;1960;2007;47
1998;83;56,08339;8,98743;1972;2021;49
1998;116;55,87377;12,4726;1998;2011;13
1998;130;55,67057;11,18151;1899;2021;122
1998;136;55,50785;9,47085;1972;1998;26
1998;149;54,77112;10,71543;1984;2001;17
1998;170;55,50629;9,75098;1964;2001;37
1998;171;55,48663;9,86367;1959;2008;49
1998;206;55,94836;11,59794;1993;2000;7
1998;208;55,74166;11,41925;1865;2021;156
1998;219;55,66464;12,09277;1930;2001;71
1998;245;55,35164;11,32714;1938;2021;83
1998;272;54,89137;9,8371;1983;2001;18
1998;276;56,95147;8,58714;1982;2000;18
1998;291;55,78719;8,25611;1985;2007;22
1998;299;55,77169;9,47224;1960;2021;61
1998;309;56,76125;9,23757;1981;1998;17
1998;335;57,04003;10,01645;1982;2021;39
1998;337;56,13962;10,20498;1928;2004;76
1999;3;55,412663;10,12987;1970;2011;41
1999;5;55,146277;10,020784;1995;2012;17
1999;6;55,269626;10,11524;1877;2009;132
1999;17;57,277261;9,94587;1986;2021;35
1999;35;55,3225039;11,9608428;1920;2010;90
1999;38;55,973541;12,534777;1946;2021;75
1999;46;57,623216;10,430582;1985;2011;26
1999;50;55,8569401;12,0706508;1985;2010;25
1999;55;55,242371;10,53961;1866;2021;155
1999;64;54,689732;11,964726;1971;2021;50
1999;69;55,182844;9,45901;1920;2004;84
1999;73;55,84433;9,589121;1848;2021;173
1999;77;56,028439;12,589834;1921;2021;100
1999;79;56,051014;12,584655;1969;2008;39
1999;84;55,952225;8,782211;1986;2006;20
1999;87;55,941434;12,268503;1937;2021;84
1999;88;55,944946;12,309925;1923;2021;98
1999;91;57,585341;9,980745;1983;2004;21
1999;93;57,356497;9,936222;1890;2021;131
1999;95;55,704063;11,690361;1963;2021;58
1999;102;56,359714;8,597986;1973;2004;31
1999;104;55,92122;9,997713;1979;2000;21
1999;110;55,965642;9,717756;1884;2006;122
1999;119;55,9551036;9,1145709;1993;2002;9
1999;121;55,9653067;9,094499;1993;2021;28
1999;122;56,148673;9,142385;1994;2021;27
1999;131;55,46168;10,663878;1952;2005;53
1999;133;55,4967868;9,4924387;1983;2001;18
1999;135;55,482156;9,451854;1949;2021;72
1999;144;55,673798;12,577517;1891;2021;130
1999;145;55,682456;12,569828;1877;2021;144
1999;156;56,546487;8,414392;1971;2021;50
1999;159;54,797991;11,516179;1986;2001;15
1999;165;56,6472378;9,970264;1954;2021;67
1999;169;55,490971;9,972686;1986;2021;35
1999;183;56,410263;10,747305;1996;2015;19
1999;185;55,548046;10,108677;1998;1999;1
1999;194;55,92104;10,25164;1956;2021;65
1999;195;55,9775064;10,1756177;1890;2021;131
1999;196;55,991623;10,251408;1972;2015;43
1999;204;55,837896;11,551628;1991;2021;30
1999;207;55,960508;11,749297;1980;2015;35
1999;215;56,886164;9,836899;1886;2009;123
1999;217;56,06639;8,314841;1969;2021;52
1999;218;55,512414;11,688584;1991;2000;9
1999;225;55,801472;10,556744;1984;2012;28
1999;230;56,178325;9,590822;1971;2021;50
1999;236;56,090396;9,758625;1892;2021;129
1999;239;56,572888;9,051158;1907;2021;114
1999;248;55,2506641;11,274915;1973;2005;32
1999;256;55,070962;10,511664;1920;2021;101
1999;258;55,1225643;10,7284368;1989;2021;32
1999;262;56,193792;10,691846;1993;2021;28
1999;270;56,302138;10,477471;1894;2021;127
1999;271;54,986632;9,977204;1920;2002;82
1999;273;54,898325;9,802925;1952;2021;69
1999;283;55,054318;8,950471;1960;2021;61
1999;285;55,1913926;9,066302;1984;2021;37
1999;294;55,471013;9,099652;1865;2021;156
1999;301;55,643464;9,651961;1889;2021;132
1999;302;55,715222;9,319221;1940;2021;81
1999;307;55,716877;9,585268;1943;2021;78
1999;314;56,377182;9,64424;1972;2021;49
1999;315;56,552152;9,40118;1868;2021;153
1999;316;56,441433;9,422904;1951;2021;70
1999;322;54,9748134;12,2737822;1866;2021;155
1999;324;54,924137;10,278204;1985;2021;36
1999;325;54,889128;10,412794;1978;2011;33
1999;327;55,030253;9,419819;1993;2020;27
1999;328;54,873518;9,518945;1921;2021;100
1999;336;56,032176;10,125522;1869;2005;136
1999;339;56,214752;10,27358;1970;2021;51
1999;342;56,1956788;10,2204946;1970;2021;51
1999;343;56,101781;10,070482;1971;2011;40
1999;346;56,067076;10,134812;1866;2021;155
1999;13;55,18902;14,96054;1867;2021;154
1999;23;55,48022;8,43888;1910;2012;102
1999;26;55,28979;8,68128;1970;2021;51
1999;29;56,328077;10,04661;1876;2021;145
1999;82;56,13374;9,0217;1960;2007;47
1999;83;56,08339;8,98743;1972;2021;49
1999;116;55,87377;12,4726;1998;2011;13
1999;130;55,67057;11,18151;1899;2021;122
1999;149;54,77112;10,71543;1984;2001;17
1999;170;55,50629;9,75098;1964;2001;37
1999;171;55,48663;9,86367;1959;2008;49
1999;206;55,94836;11,59794;1993;2000;7
1999;208;55,74166;11,41925;1865;2021;156
1999;219;55,66464;12,09277;1930;2001;71
1999;245;55,35164;11,32714;1938;2021;83
1999;272;54,89137;9,8371;1983;2001;18
1999;276;56,95147;8,58714;1982;2000;18
1999;291;55,78719;8,25611;1985;2007;22
1999;299;55,77169;9,47224;1960;2021;61
1999;335;57,04003;10,01645;1982;2021;39
1999;337;56,13962;10,20498;1928;2004;76
2000;3;55,412663;10,12987;1970;2011;41
2000;5;55,146277;10,020784;1995;2012;17
2000;6;55,269626;10,11524;1877;2009;132
2000;17;57,277261;9,94587;1986;2021;35
2000;35;55,3225039;11,9608428;1920;2010;90
2000;38;55,973541;12,534777;1946;2021;75
2000;46;57,623216;10,430582;1985;2011;26
2000;50;55,8569401;12,0706508;1985;2010;25
2000;55;55,242371;10,53961;1866;2021;155
2000;64;54,689732;11,964726;1971;2021;50
2000;69;55,182844;9,45901;1920;2004;84
2000;73;55,84433;9,589121;1848;2021;173
2000;77;56,028439;12,589834;1921;2021;100
2000;79;56,051014;12,584655;1969;2008;39
2000;84;55,952225;8,782211;1986;2006;20
2000;87;55,941434;12,268503;1937;2021;84
2000;88;55,944946;12,309925;1923;2021;98
2000;91;57,585341;9,980745;1983;2004;21
2000;93;57,356497;9,936222;1890;2021;131
2000;95;55,704063;11,690361;1963;2021;58
2000;102;56,359714;8,597986;1973;2004;31
2000;104;55,92122;9,997713;1979;2000;21
2000;110;55,965642;9,717756;1884;2006;122
2000;119;55,9551036;9,1145709;1993;2002;9
2000;121;55,9653067;9,094499;1993;2021;28
2000;122;56,148673;9,142385;1994;2021;27
2000;131;55,46168;10,663878;1952;2005;53
2000;133;55,4967868;9,4924387;1983;2001;18
2000;135;55,482156;9,451854;1949;2021;72
2000;144;55,673798;12,577517;1891;2021;130
2000;145;55,682456;12,569828;1877;2021;144
2000;156;56,546487;8,414392;1971;2021;50
2000;159;54,797991;11,516179;1986;2001;15
2000;165;56,6472378;9,970264;1954;2021;67
2000;169;55,490971;9,972686;1986;2021;35
2000;183;56,410263;10,747305;1996;2015;19
2000;194;55,92104;10,25164;1956;2021;65
2000;195;55,9775064;10,1756177;1890;2021;131
2000;196;55,991623;10,251408;1972;2015;43
2000;204;55,837896;11,551628;1991;2021;30
2000;207;55,960508;11,749297;1980;2015;35
2000;215;56,886164;9,836899;1886;2009;123
2000;217;56,06639;8,314841;1969;2021;52
2000;218;55,512414;11,688584;1991;2000;9
2000;225;55,801472;10,556744;1984;2012;28
2000;230;56,178325;9,590822;1971;2021;50
2000;236;56,090396;9,758625;1892;2021;129
2000;239;56,572888;9,051158;1907;2021;114
2000;248;55,2506641;11,274915;1973;2005;32
2000;256;55,070962;10,511664;1920;2021;101
2000;258;55,1225643;10,7284368;1989;2021;32
2000;262;56,193792;10,691846;1993;2021;28
2000;270;56,302138;10,477471;1894;2021;127
2000;271;54,986632;9,977204;1920;2002;82
2000;273;54,898325;9,802925;1952;2021;69
2000;283;55,054318;8,950471;1960;2021;61
2000;285;55,1913926;9,066302;1984;2021;37
2000;294;55,471013;9,099652;1865;2021;156
2000;301;55,643464;9,651961;1889;2021;132
2000;302;55,715222;9,319221;1940;2021;81
2000;307;55,716877;9,585268;1943;2021;78
2000;314;56,377182;9,64424;1972;2021;49
2000;315;56,552152;9,40118;1868;2021;153
2000;316;56,441433;9,422904;1951;2021;70
2000;322;54,9748134;12,2737822;1866;2021;155
2000;324;54,924137;10,278204;1985;2021;36
2000;325;54,889128;10,412794;1978;2011;33
2000;327;55,030253;9,419819;1993;2020;27
2000;328;54,873518;9,518945;1921;2021;100
2000;336;56,032176;10,125522;1869;2005;136
2000;339;56,214752;10,27358;1970;2021;51
2000;342;56,1956788;10,2204946;1970;2021;51
2000;343;56,101781;10,070482;1971;2011;40
2000;346;56,067076;10,134812;1866;2021;155
2000;13;55,18902;14,96054;1867;2021;154
2000;23;55,48022;8,43888;1910;2012;102
2000;26;55,28979;8,68128;1970;2021;51
2000;29;56,328077;10,04661;1876;2021;145
2000;82;56,13374;9,0217;1960;2007;47
2000;83;56,08339;8,98743;1972;2021;49
2000;116;55,87377;12,4726;1998;2011;13
2000;130;55,67057;11,18151;1899;2021;122
2000;149;54,77112;10,71543;1984;2001;17
2000;170;55,50629;9,75098;1964;2001;37
2000;171;55,48663;9,86367;1959;2008;49
2000;206;55,94836;11,59794;1993;2000;7
2000;208;55,74166;11,41925;1865;2021;156
2000;210;56,40504;10,10971;2000;2021;21
2000;219;55,66464;12,09277;1930;2001;71
2000;245;55,35164;11,32714;1938;2021;83
2000;272;54,89137;9,8371;1983;2001;18
2000;276;56,95147;8,58714;1982;2000;18
2000;291;55,78719;8,25611;1985;2007;22
2000;299;55,77169;9,47224;1960;2021;61
2000;335;57,04003;10,01645;1982;2021;39
2000;337;56,13962;10,20498;1928;2004;76
2001;3;55,412663;10,12987;1970;2011;41
2001;5;55,146277;10,020784;1995;2012;17
2001;6;55,269626;10,11524;1877;2009;132
2001;17;57,277261;9,94587;1986;2021;35
2001;35;55,3225039;11,9608428;1920;2010;90
2001;38;55,973541;12,534777;1946;2021;75
2001;46;57,623216;10,430582;1985;2011;26
2001;50;55,8569401;12,0706508;1985;2010;25
2001;55;55,242371;10,53961;1866;2021;155
2001;64;54,689732;11,964726;1971;2021;50
2001;69;55,182844;9,45901;1920;2004;84
2001;73;55,84433;9,589121;1848;2021;173
2001;77;56,028439;12,589834;1921;2021;100
2001;79;56,051014;12,584655;1969;2008;39
2001;84;55,952225;8,782211;1986;2006;20
2001;87;55,941434;12,268503;1937;2021;84
2001;88;55,944946;12,309925;1923;2021;98
2001;91;57,585341;9,980745;1983;2004;21
2001;93;57,356497;9,936222;1890;2021;131
2001;95;55,704063;11,690361;1963;2021;58
2001;102;56,359714;8,597986;1973;2004;31
2001;110;55,965642;9,717756;1884;2006;122
2001;119;55,9551036;9,1145709;1993;2002;9
2001;121;55,9653067;9,094499;1993;2021;28
2001;122;56,148673;9,142385;1994;2021;27
2001;131;55,46168;10,663878;1952;2005;53
2001;133;55,4967868;9,4924387;1983;2001;18
2001;135;55,482156;9,451854;1949;2021;72
2001;144;55,673798;12,577517;1891;2021;130
2001;145;55,682456;12,569828;1877;2021;144
2001;156;56,546487;8,414392;1971;2021;50
2001;159;54,797991;11,516179;1986;2001;15
2001;165;56,6472378;9,970264;1954;2021;67
2001;169;55,490971;9,972686;1986;2021;35
2001;183;56,410263;10,747305;1996;2015;19
2001;194;55,92104;10,25164;1956;2021;65
2001;195;55,9775064;10,1756177;1890;2021;131
2001;196;55,991623;10,251408;1972;2015;43
2001;204;55,837896;11,551628;1991;2021;30
2001;207;55,960508;11,749297;1980;2015;35
2001;215;56,886164;9,836899;1886;2009;123
2001;217;56,06639;8,314841;1969;2021;52
2001;225;55,801472;10,556744;1984;2012;28
2001;230;56,178325;9,590822;1971;2021;50
2001;236;56,090396;9,758625;1892;2021;129
2001;239;56,572888;9,051158;1907;2021;114
2001;248;55,2506641;11,274915;1973;2005;32
2001;256;55,070962;10,511664;1920;2021;101
2001;258;55,1225643;10,7284368;1989;2021;32
2001;262;56,193792;10,691846;1993;2021;28
2001;270;56,302138;10,477471;1894;2021;127
2001;271;54,986632;9,977204;1920;2002;82
2001;273;54,898325;9,802925;1952;2021;69
2001;283;55,054318;8,950471;1960;2021;61
2001;285;55,1913926;9,066302;1984;2021;37
2001;294;55,471013;9,099652;1865;2021;156
2001;301;55,643464;9,651961;1889;2021;132
2001;302;55,715222;9,319221;1940;2021;81
2001;307;55,716877;9,585268;1943;2021;78
2001;314;56,377182;9,64424;1972;2021;49
2001;315;56,552152;9,40118;1868;2021;153
2001;316;56,441433;9,422904;1951;2021;70
2001;322;54,9748134;12,2737822;1866;2021;155
2001;324;54,924137;10,278204;1985;2021;36
2001;325;54,889128;10,412794;1978;2011;33
2001;327;55,030253;9,419819;1993;2020;27
2001;328;54,873518;9,518945;1921;2021;100
2001;336;56,032176;10,125522;1869;2005;136
2001;339;56,214752;10,27358;1970;2021;51
2001;342;56,1956788;10,2204946;1970;2021;51
2001;343;56,101781;10,070482;1971;2011;40
2001;346;56,067076;10,134812;1866;2021;155
2001;13;55,18902;14,96054;1867;2021;154
2001;23;55,48022;8,43888;1910;2012;102
2001;26;55,28979;8,68128;1970;2021;51
2001;29;56,328077;10,04661;1876;2021;145
2001;82;56,13374;9,0217;1960;2007;47
2001;83;56,08339;8,98743;1972;2021;49
2001;116;55,87377;12,4726;1998;2011;13
2001;130;55,67057;11,18151;1899;2021;122
2001;149;54,77112;10,71543;1984;2001;17
2001;170;55,50629;9,75098;1964;2001;37
2001;171;55,48663;9,86367;1959;2008;49
2001;208;55,74166;11,41925;1865;2021;156
2001;210;56,40504;10,10971;2000;2021;21
2001;219;55,66464;12,09277;1930;2001;71
2001;245;55,35164;11,32714;1938;2021;83
2001;272;54,89137;9,8371;1983;2001;18
2001;291;55,78719;8,25611;1985;2007;22
2001;299;55,77169;9,47224;1960;2021;61
2001;335;57,04003;10,01645;1982;2021;39
2001;337;56,13962;10,20498;1928;2004;76
2002;3;55,412663;10,12987;1970;2011;41
2002;5;55,146277;10,020784;1995;2012;17
2002;6;55,269626;10,11524;1877;2009;132
2002;17;57,277261;9,94587;1986;2021;35
2002;35;55,3225039;11,9608428;1920;2010;90
2002;38;55,973541;12,534777;1946;2021;75
2002;46;57,623216;10,430582;1985;2011;26
2002;50;55,8569401;12,0706508;1985;2010;25
2002;55;55,242371;10,53961;1866;2021;155
2002;64;54,689732;11,964726;1971;2021;50
2002;69;55,182844;9,45901;1920;2004;84
2002;73;55,84433;9,589121;1848;2021;173
2002;77;56,028439;12,589834;1921;2021;100
2002;79;56,051014;12,584655;1969;2008;39
2002;84;55,952225;8,782211;1986;2006;20
2002;87;55,941434;12,268503;1937;2021;84
2002;88;55,944946;12,309925;1923;2021;98
2002;91;57,585341;9,980745;1983;2004;21
2002;93;57,356497;9,936222;1890;2021;131
2002;95;55,704063;11,690361;1963;2021;58
2002;102;56,359714;8,597986;1973;2004;31
2002;110;55,965642;9,717756;1884;2006;122
2002;119;55,9551036;9,1145709;1993;2002;9
2002;121;55,9653067;9,094499;1993;2021;28
2002;122;56,148673;9,142385;1994;2021;27
2002;131;55,46168;10,663878;1952;2005;53
2002;135;55,482156;9,451854;1949;2021;72
2002;144;55,673798;12,577517;1891;2021;130
2002;145;55,682456;12,569828;1877;2021;144
2002;156;56,546487;8,414392;1971;2021;50
2002;165;56,6472378;9,970264;1954;2021;67
2002;169;55,490971;9,972686;1986;2021;35
2002;183;56,410263;10,747305;1996;2015;19
2002;194;55,92104;10,25164;1956;2021;65
2002;195;55,9775064;10,1756177;1890;2021;131
2002;196;55,991623;10,251408;1972;2015;43
2002;204;55,837896;11,551628;1991;2021;30
2002;207;55,960508;11,749297;1980;2015;35
2002;215;56,886164;9,836899;1886;2009;123
2002;217;56,06639;8,314841;1969;2021;52
2002;225;55,801472;10,556744;1984;2012;28
2002;230;56,178325;9,590822;1971;2021;50
2002;236;56,090396;9,758625;1892;2021;129
2002;239;56,572888;9,051158;1907;2021;114
2002;248;55,2506641;11,274915;1973;2005;32
2002;256;55,070962;10,511664;1920;2021;101
2002;258;55,1225643;10,7284368;1989;2021;32
2002;262;56,193792;10,691846;1993;2021;28
2002;265;56,279076;10,501631;2002;2012;10
2002;270;56,302138;10,477471;1894;2021;127
2002;271;54,986632;9,977204;1920;2002;82
2002;273;54,898325;9,802925;1952;2021;69
2002;283;55,054318;8,950471;1960;2021;61
2002;285;55,1913926;9,066302;1984;2021;37
2002;294;55,471013;9,099652;1865;2021;156
2002;301;55,643464;9,651961;1889;2021;132
2002;302;55,715222;9,319221;1940;2021;81
2002;307;55,716877;9,585268;1943;2021;78
2002;314;56,377182;9,64424;1972;2021;49
2002;315;56,552152;9,40118;1868;2021;153
2002;316;56,441433;9,422904;1951;2021;70
2002;322;54,9748134;12,2737822;1866;2021;155
2002;324;54,924137;10,278204;1985;2021;36
2002;325;54,889128;10,412794;1978;2011;33
2002;327;55,030253;9,419819;1993;2020;27
2002;328;54,873518;9,518945;1921;2021;100
2002;336;56,032176;10,125522;1869;2005;136
2002;339;56,214752;10,27358;1970;2021;51
2002;342;56,1956788;10,2204946;1970;2021;51
2002;343;56,101781;10,070482;1971;2011;40
2002;346;56,067076;10,134812;1866;2021;155
2002;13;55,18902;14,96054;1867;2021;154
2002;23;55,48022;8,43888;1910;2012;102
2002;26;55,28979;8,68128;1970;2021;51
2002;29;56,328077;10,04661;1876;2021;145
2002;82;56,13374;9,0217;1960;2007;47
2002;83;56,08339;8,98743;1972;2021;49
2002;116;55,87377;12,4726;1998;2011;13
2002;130;55,67057;11,18151;1899;2021;122
2002;171;55,48663;9,86367;1959;2008;49
2002;208;55,74166;11,41925;1865;2021;156
2002;210;56,40504;10,10971;2000;2021;21
2002;245;55,35164;11,32714;1938;2021;83
2002;263;56,32492;10,69459;2002;2021;19
2002;291;55,78719;8,25611;1985;2007;22
2002;299;55,77169;9,47224;1960;2021;61
2002;335;57,04003;10,01645;1982;2021;39
2002;337;56,13962;10,20498;1928;2004;76
2003;3;55,412663;10,12987;1970;2011;41
2003;5;55,146277;10,020784;1995;2012;17
2003;6;55,269626;10,11524;1877;2009;132
2003;17;57,277261;9,94587;1986;2021;35
2003;35;55,3225039;11,9608428;1920;2010;90
2003;38;55,973541;12,534777;1946;2021;75
2003;46;57,623216;10,430582;1985;2011;26
2003;50;55,8569401;12,0706508;1985;2010;25
2003;55;55,242371;10,53961;1866;2021;155
2003;64;54,689732;11,964726;1971;2021;50
2003;69;55,182844;9,45901;1920;2004;84
2003;73;55,84433;9,589121;1848;2021;173
2003;77;56,028439;12,589834;1921;2021;100
2003;79;56,051014;12,584655;1969;2008;39
2003;84;55,952225;8,782211;1986;2006;20
2003;87;55,941434;12,268503;1937;2021;84
2003;88;55,944946;12,309925;1923;2021;98
2003;91;57,585341;9,980745;1983;2004;21
2003;93;57,356497;9,936222;1890;2021;131
2003;95;55,704063;11,690361;1963;2021;58
2003;102;56,359714;8,597986;1973;2004;31
2003;110;55,965642;9,717756;1884;2006;122
2003;121;55,9653067;9,094499;1993;2021;28
2003;122;56,148673;9,142385;1994;2021;27
2003;131;55,46168;10,663878;1952;2005;53
2003;135;55,482156;9,451854;1949;2021;72
2003;144;55,673798;12,577517;1891;2021;130
2003;145;55,682456;12,569828;1877;2021;144
2003;156;56,546487;8,414392;1971;2021;50
2003;165;56,6472378;9,970264;1954;2021;67
2003;169;55,490971;9,972686;1986;2021;35
2003;183;56,410263;10,747305;1996;2015;19
2003;194;55,92104;10,25164;1956;2021;65
2003;195;55,9775064;10,1756177;1890;2021;131
2003;196;55,991623;10,251408;1972;2015;43
2003;204;55,837896;11,551628;1991;2021;30
2003;207;55,960508;11,749297;1980;2015;35
2003;215;56,886164;9,836899;1886;2009;123
2003;217;56,06639;8,314841;1969;2021;52
2003;225;55,801472;10,556744;1984;2012;28
2003;230;56,178325;9,590822;1971;2021;50
2003;236;56,090396;9,758625;1892;2021;129
2003;239;56,572888;9,051158;1907;2021;114
2003;248;55,2506641;11,274915;1973;2005;32
2003;256;55,070962;10,511664;1920;2021;101
2003;258;55,1225643;10,7284368;1989;2021;32
2003;262;56,193792;10,691846;1993;2021;28
2003;265;56,279076;10,501631;2002;2012;10
2003;270;56,302138;10,477471;1894;2021;127
2003;273;54,898325;9,802925;1952;2021;69
2003;283;55,054318;8,950471;1960;2021;61
2003;285;55,1913926;9,066302;1984;2021;37
2003;294;55,471013;9,099652;1865;2021;156
2003;301;55,643464;9,651961;1889;2021;132
2003;302;55,715222;9,319221;1940;2021;81
2003;307;55,716877;9,585268;1943;2021;78
2003;314;56,377182;9,64424;1972;2021;49
2003;315;56,552152;9,40118;1868;2021;153
2003;316;56,441433;9,422904;1951;2021;70
2003;322;54,9748134;12,2737822;1866;2021;155
2003;324;54,924137;10,278204;1985;2021;36
2003;325;54,889128;10,412794;1978;2011;33
2003;327;55,030253;9,419819;1993;2020;27
2003;328;54,873518;9,518945;1921;2021;100
2003;336;56,032176;10,125522;1869;2005;136
2003;339;56,214752;10,27358;1970;2021;51
2003;342;56,1956788;10,2204946;1970;2021;51
2003;343;56,101781;10,070482;1971;2011;40
2003;346;56,067076;10,134812;1866;2021;155
2003;13;55,18902;14,96054;1867;2021;154
2003;23;55,48022;8,43888;1910;2012;102
2003;26;55,28979;8,68128;1970;2021;51
2003;29;56,328077;10,04661;1876;2021;145
2003;82;56,13374;9,0217;1960;2007;47
2003;83;56,08339;8,98743;1972;2021;49
2003;116;55,87377;12,4726;1998;2011;13
2003;130;55,67057;11,18151;1899;2021;122
2003;171;55,48663;9,86367;1959;2008;49
2003;208;55,74166;11,41925;1865;2021;156
2003;210;56,40504;10,10971;2000;2021;21
2003;245;55,35164;11,32714;1938;2021;83
2003;263;56,32492;10,69459;2002;2021;19
2003;291;55,78719;8,25611;1985;2007;22
2003;299;55,77169;9,47224;1960;2021;61
2003;335;57,04003;10,01645;1982;2021;39
2003;337;56,13962;10,20498;1928;2004;76
2004;3;55,412663;10,12987;1970;2011;41
2004;5;55,146277;10,020784;1995;2012;17
2004;6;55,269626;10,11524;1877;2009;132
2004;17;57,277261;9,94587;1986;2021;35
2004;35;55,3225039;11,9608428;1920;2010;90
2004;38;55,973541;12,534777;1946;2021;75
2004;40;55,522881;9,709432;2004;2021;17
2004;46;57,623216;10,430582;1985;2011;26
2004;50;55,8569401;12,0706508;1985;2010;25
2004;55;55,242371;10,53961;1866;2021;155
2004;64;54,689732;11,964726;1971;2021;50
2004;69;55,182844;9,45901;1920;2004;84
2004;73;55,84433;9,589121;1848;2021;173
2004;77;56,028439;12,589834;1921;2021;100
2004;79;56,051014;12,584655;1969;2008;39
2004;84;55,952225;8,782211;1986;2006;20
2004;87;55,941434;12,268503;1937;2021;84
2004;88;55,944946;12,309925;1923;2021;98
2004;91;57,585341;9,980745;1983;2004;21
2004;93;57,356497;9,936222;1890;2021;131
2004;95;55,704063;11,690361;1963;2021;58
2004;102;56,359714;8,597986;1973;2004;31
2004;110;55,965642;9,717756;1884;2006;122
2004;121;55,9653067;9,094499;1993;2021;28
2004;122;56,148673;9,142385;1994;2021;27
2004;131;55,46168;10,663878;1952;2005;53
2004;135;55,482156;9,451854;1949;2021;72
2004;144;55,673798;12,577517;1891;2021;130
2004;145;55,682456;12,569828;1877;2021;144
2004;156;56,546487;8,414392;1971;2021;50
2004;165;56,6472378;9,970264;1954;2021;67
2004;169;55,490971;9,972686;1986;2021;35
2004;183;56,410263;10,747305;1996;2015;19
2004;194;55,92104;10,25164;1956;2021;65
2004;195;55,9775064;10,1756177;1890;2021;131
2004;196;55,991623;10,251408;1972;2015;43
2004;204;55,837896;11,551628;1991;2021;30
2004;207;55,960508;11,749297;1980;2015;35
2004;215;56,886164;9,836899;1886;2009;123
2004;217;56,06639;8,314841;1969;2021;52
2004;225;55,801472;10,556744;1984;2012;28
2004;230;56,178325;9,590822;1971;2021;50
2004;236;56,090396;9,758625;1892;2021;129
2004;239;56,572888;9,051158;1907;2021;114
2004;248;55,2506641;11,274915;1973;2005;32
2004;256;55,070962;10,511664;1920;2021;101
2004;258;55,1225643;10,7284368;1989;2021;32
2004;262;56,193792;10,691846;1993;2021;28
2004;265;56,279076;10,501631;2002;2012;10
2004;270;56,302138;10,477471;1894;2021;127
2004;273;54,898325;9,802925;1952;2021;69
2004;283;55,054318;8,950471;1960;2021;61
2004;285;55,1913926;9,066302;1984;2021;37
2004;294;55,471013;9,099652;1865;2021;156
2004;301;55,643464;9,651961;1889;2021;132
2004;302;55,715222;9,319221;1940;2021;81
2004;307;55,716877;9,585268;1943;2021;78
2004;314;56,377182;9,64424;1972;2021;49
2004;315;56,552152;9,40118;1868;2021;153
2004;316;56,441433;9,422904;1951;2021;70
2004;322;54,9748134;12,2737822;1866;2021;155
2004;324;54,924137;10,278204;1985;2021;36
2004;325;54,889128;10,412794;1978;2011;33
2004;327;55,030253;9,419819;1993;2020;27
2004;328;54,873518;9,518945;1921;2021;100
2004;336;56,032176;10,125522;1869;2005;136
2004;339;56,214752;10,27358;1970;2021;51
2004;342;56,1956788;10,2204946;1970;2021;51
2004;343;56,101781;10,070482;1971;2011;40
2004;346;56,067076;10,134812;1866;2021;155
2004;13;55,18902;14,96054;1867;2021;154
2004;23;55,48022;8,43888;1910;2012;102
2004;26;55,28979;8,68128;1970;2021;51
2004;29;56,328077;10,04661;1876;2021;145
2004;82;56,13374;9,0217;1960;2007;47
2004;83;56,08339;8,98743;1972;2021;49
2004;116;55,87377;12,4726;1998;2011;13
2004;130;55,67057;11,18151;1899;2021;122
2004;171;55,48663;9,86367;1959;2008;49
2004;208;55,74166;11,41925;1865;2021;156
2004;210;56,40504;10,10971;2000;2021;21
2004;245;55,35164;11,32714;1938;2021;83
2004;263;56,32492;10,69459;2002;2021;19
2004;291;55,78719;8,25611;1985;2007;22
2004;299;55,77169;9,47224;1960;2021;61
2004;335;57,04003;10,01645;1982;2021;39
2004;337;56,13962;10,20498;1928;2004;76
2005;3;55,412663;10,12987;1970;2011;41
2005;5;55,146277;10,020784;1995;2012;17
2005;6;55,269626;10,11524;1877;2009;132
2005;17;57,277261;9,94587;1986;2021;35
2005;35;55,3225039;11,9608428;1920;2010;90
2005;38;55,973541;12,534777;1946;2021;75
2005;40;55,522881;9,709432;2004;2021;17
2005;46;57,623216;10,430582;1985;2011;26
2005;50;55,8569401;12,0706508;1985;2010;25
2005;55;55,242371;10,53961;1866;2021;155
2005;64;54,689732;11,964726;1971;2021;50
2005;73;55,84433;9,589121;1848;2021;173
2005;77;56,028439;12,589834;1921;2021;100
2005;79;56,051014;12,584655;1969;2008;39
2005;84;55,952225;8,782211;1986;2006;20
2005;87;55,941434;12,268503;1937;2021;84
2005;88;55,944946;12,309925;1923;2021;98
2005;93;57,356497;9,936222;1890;2021;131
2005;95;55,704063;11,690361;1963;2021;58
2005;110;55,965642;9,717756;1884;2006;122
2005;121;55,9653067;9,094499;1993;2021;28
2005;122;56,148673;9,142385;1994;2021;27
2005;131;55,46168;10,663878;1952;2005;53
2005;135;55,482156;9,451854;1949;2021;72
2005;144;55,673798;12,577517;1891;2021;130
2005;145;55,682456;12,569828;1877;2021;144
2005;156;56,546487;8,414392;1971;2021;50
2005;165;56,6472378;9,970264;1954;2021;67
2005;169;55,490971;9,972686;1986;2021;35
2005;183;56,410263;10,747305;1996;2015;19
2005;187;55,548046;10,108677;2005;2021;16
2005;194;55,92104;10,25164;1956;2021;65
2005;195;55,9775064;10,1756177;1890;2021;131
2005;196;55,991623;10,251408;1972;2015;43
2005;204;55,837896;11,551628;1991;2021;30
2005;207;55,960508;11,749297;1980;2015;35
2005;215;56,886164;9,836899;1886;2009;123
2005;217;56,06639;8,314841;1969;2021;52
2005;225;55,801472;10,556744;1984;2012;28
2005;230;56,178325;9,590822;1971;2021;50
2005;236;56,090396;9,758625;1892;2021;129
2005;239;56,572888;9,051158;1907;2021;114
2005;248;55,2506641;11,274915;1973;2005;32
2005;256;55,070962;10,511664;1920;2021;101
2005;258;55,1225643;10,7284368;1989;2021;32
2005;262;56,193792;10,691846;1993;2021;28
2005;265;56,279076;10,501631;2002;2012;10
2005;270;56,302138;10,477471;1894;2021;127
2005;273;54,898325;9,802925;1952;2021;69
2005;283;55,054318;8,950471;1960;2021;61
2005;285;55,1913926;9,066302;1984;2021;37
2005;294;55,471013;9,099652;1865;2021;156
2005;301;55,643464;9,651961;1889;2021;132
2005;302;55,715222;9,319221;1940;2021;81
2005;307;55,716877;9,585268;1943;2021;78
2005;314;56,377182;9,64424;1972;2021;49
2005;315;56,552152;9,40118;1868;2021;153
2005;316;56,441433;9,422904;1951;2021;70
2005;322;54,9748134;12,2737822;1866;2021;155
2005;324;54,924137;10,278204;1985;2021;36
2005;325;54,889128;10,412794;1978;2011;33
2005;327;55,030253;9,419819;1993;2020;27
2005;328;54,873518;9,518945;1921;2021;100
2005;336;56,032176;10,125522;1869;2005;136
2005;339;56,214752;10,27358;1970;2021;51
2005;342;56,1956788;10,2204946;1970;2021;51
2005;343;56,101781;10,070482;1971;2011;40
2005;346;56,067076;10,134812;1866;2021;155
2005;13;55,18902;14,96054;1867;2021;154
2005;23;55,48022;8,43888;1910;2012;102
2005;26;55,28979;8,68128;1970;2021;51
2005;29;56,328077;10,04661;1876;2021;145
2005;82;56,13374;9,0217;1960;2007;47
2005;83;56,08339;8,98743;1972;2021;49
2005;116;55,87377;12,4726;1998;2011;13
2005;130;55,67057;11,18151;1899;2021;122
2005;171;55,48663;9,86367;1959;2008;49
2005;208;55,74166;11,41925;1865;2021;156
2005;210;56,40504;10,10971;2000;2021;21
2005;245;55,35164;11,32714;1938;2021;83
2005;263;56,32492;10,69459;2002;2021;19
2005;291;55,78719;8,25611;1985;2007;22
2005;299;55,77169;9,47224;1960;2021;61
2005;335;57,04003;10,01645;1982;2021;39
2006;3;55,412663;10,12987;1970;2011;41
2006;5;55,146277;10,020784;1995;2012;17
2006;6;55,269626;10,11524;1877;2009;132
2006;17;57,277261;9,94587;1986;2021;35
2006;35;55,3225039;11,9608428;1920;2010;90
2006;38;55,973541;12,534777;1946;2021;75
2006;40;55,522881;9,709432;2004;2021;17
2006;46;57,623216;10,430582;1985;2011;26
2006;50;55,8569401;12,0706508;1985;2010;25
2006;55;55,242371;10,53961;1866;2021;155
2006;64;54,689732;11,964726;1971;2021;50
2006;73;55,84433;9,589121;1848;2021;173
2006;77;56,028439;12,589834;1921;2021;100
2006;79;56,051014;12,584655;1969;2008;39
2006;84;55,952225;8,782211;1986;2006;20
2006;87;55,941434;12,268503;1937;2021;84
2006;88;55,944946;12,309925;1923;2021;98
2006;93;57,356497;9,936222;1890;2021;131
2006;95;55,704063;11,690361;1963;2021;58
2006;110;55,965642;9,717756;1884;2006;122
2006;121;55,9653067;9,094499;1993;2021;28
2006;122;56,148673;9,142385;1994;2021;27
2006;135;55,482156;9,451854;1949;2021;72
2006;144;55,673798;12,577517;1891;2021;130
2006;145;55,682456;12,569828;1877;2021;144
2006;156;56,546487;8,414392;1971;2021;50
2006;165;56,6472378;9,970264;1954;2021;67
2006;169;55,490971;9,972686;1986;2021;35
2006;183;56,410263;10,747305;1996;2015;19
2006;187;55,548046;10,108677;2005;2021;16
2006;194;55,92104;10,25164;1956;2021;65
2006;195;55,9775064;10,1756177;1890;2021;131
2006;196;55,991623;10,251408;1972;2015;43
2006;204;55,837896;11,551628;1991;2021;30
2006;207;55,960508;11,749297;1980;2015;35
2006;215;56,886164;9,836899;1886;2009;123
2006;217;56,06639;8,314841;1969;2021;52
2006;225;55,801472;10,556744;1984;2012;28
2006;229;56,171178;9,556222;2006;2014;8
2006;230;56,178325;9,590822;1971;2021;50
2006;236;56,090396;9,758625;1892;2021;129
2006;239;56,572888;9,051158;1907;2021;114
2006;256;55,070962;10,511664;1920;2021;101
2006;258;55,1225643;10,7284368;1989;2021;32
2006;262;56,193792;10,691846;1993;2021;28
2006;265;56,279076;10,501631;2002;2012;10
2006;270;56,302138;10,477471;1894;2021;127
2006;273;54,898325;9,802925;1952;2021;69
2006;283;55,054318;8,950471;1960;2021;61
2006;285;55,1913926;9,066302;1984;2021;37
2006;294;55,471013;9,099652;1865;2021;156
2006;301;55,643464;9,651961;1889;2021;132
2006;302;55,715222;9,319221;1940;2021;81
2006;307;55,716877;9,585268;1943;2021;78
2006;314;56,377182;9,64424;1972;2021;49
2006;315;56,552152;9,40118;1868;2021;153
2006;316;56,441433;9,422904;1951;2021;70
2006;322;54,9748134;12,2737822;1866;2021;155
2006;324;54,924137;10,278204;1985;2021;36
2006;325;54,889128;10,412794;1978;2011;33
2006;327;55,030253;9,419819;1993;2020;27
2006;328;54,873518;9,518945;1921;2021;100
2006;339;56,214752;10,27358;1970;2021;51
2006;342;56,1956788;10,2204946;1970;2021;51
2006;343;56,101781;10,070482;1971;2011;40
2006;346;56,067076;10,134812;1866;2021;155
2006;13;55,18902;14,96054;1867;2021;154
2006;23;55,48022;8,43888;1910;2012;102
2006;26;55,28979;8,68128;1970;2021;51
2006;29;56,328077;10,04661;1876;2021;145
2006;82;56,13374;9,0217;1960;2007;47
2006;83;56,08339;8,98743;1972;2021;49
2006;116;55,87377;12,4726;1998;2011;13
2006;130;55,67057;11,18151;1899;2021;122
2006;171;55,48663;9,86367;1959;2008;49
2006;208;55,74166;11,41925;1865;2021;156
2006;210;56,40504;10,10971;2000;2021;21
2006;245;55,35164;11,32714;1938;2021;83
2006;263;56,32492;10,69459;2002;2021;19
2006;291;55,78719;8,25611;1985;2007;22
2006;299;55,77169;9,47224;1960;2021;61
2006;335;57,04003;10,01645;1982;2021;39
2007;3;55,412663;10,12987;1970;2011;41
2007;5;55,146277;10,020784;1995;2012;17
2007;6;55,269626;10,11524;1877;2009;132
2007;17;57,277261;9,94587;1986;2021;35
2007;35;55,3225039;11,9608428;1920;2010;90
2007;38;55,973541;12,534777;1946;2021;75
2007;40;55,522881;9,709432;2004;2021;17
2007;46;57,623216;10,430582;1985;2011;26
2007;50;55,8569401;12,0706508;1985;2010;25
2007;55;55,242371;10,53961;1866;2021;155
2007;64;54,689732;11,964726;1971;2021;50
2007;73;55,84433;9,589121;1848;2021;173
2007;77;56,028439;12,589834;1921;2021;100
2007;79;56,051014;12,584655;1969;2008;39
2007;87;55,941434;12,268503;1937;2021;84
2007;88;55,944946;12,309925;1923;2021;98
2007;93;57,356497;9,936222;1890;2021;131
2007;95;55,704063;11,690361;1963;2021;58
2007;121;55,9653067;9,094499;1993;2021;28
2007;122;56,148673;9,142385;1994;2021;27
2007;135;55,482156;9,451854;1949;2021;72
2007;144;55,673798;12,577517;1891;2021;130
2007;145;55,682456;12,569828;1877;2021;144
2007;154;56,520745;8,460418;2007;2021;14
2007;156;56,546487;8,414392;1971;2021;50
2007;165;56,6472378;9,970264;1954;2021;67
2007;169;55,490971;9,972686;1986;2021;35
2007;183;56,410263;10,747305;1996;2015;19
2007;187;55,548046;10,108677;2005;2021;16
2007;194;55,92104;10,25164;1956;2021;65
2007;195;55,9775064;10,1756177;1890;2021;131
2007;196;55,991623;10,251408;1972;2015;43
2007;204;55,837896;11,551628;1991;2021;30
2007;207;55,960508;11,749297;1980;2015;35
2007;215;56,886164;9,836899;1886;2009;123
2007;217;56,06639;8,314841;1969;2021;52
2007;225;55,801472;10,556744;1984;2012;28
2007;229;56,171178;9,556222;2006;2014;8
2007;230;56,178325;9,590822;1971;2021;50
2007;236;56,090396;9,758625;1892;2021;129
2007;239;56,572888;9,051158;1907;2021;114
2007;256;55,070962;10,511664;1920;2021;101
2007;258;55,1225643;10,7284368;1989;2021;32
2007;262;56,193792;10,691846;1993;2021;28
2007;265;56,279076;10,501631;2002;2012;10
2007;270;56,302138;10,477471;1894;2021;127
2007;273;54,898325;9,802925;1952;2021;69
2007;283;55,054318;8,950471;1960;2021;61
2007;285;55,1913926;9,066302;1984;2021;37
2007;294;55,471013;9,099652;1865;2021;156
2007;301;55,643464;9,651961;1889;2021;132
2007;302;55,715222;9,319221;1940;2021;81
2007;307;55,716877;9,585268;1943;2021;78
2007;314;56,377182;9,64424;1972;2021;49
2007;315;56,552152;9,40118;1868;2021;153
2007;316;56,441433;9,422904;1951;2021;70
2007;322;54,9748134;12,2737822;1866;2021;155
2007;324;54,924137;10,278204;1985;2021;36
2007;325;54,889128;10,412794;1978;2011;33
2007;327;55,030253;9,419819;1993;2020;27
2007;328;54,873518;9,518945;1921;2021;100
2007;339;56,214752;10,27358;1970;2021;51
2007;342;56,1956788;10,2204946;1970;2021;51
2007;343;56,101781;10,070482;1971;2011;40
2007;346;56,067076;10,134812;1866;2021;155
2007;13;55,18902;14,96054;1867;2021;154
2007;23;55,48022;8,43888;1910;2012;102
2007;26;55,28979;8,68128;1970;2021;51
2007;29;56,328077;10,04661;1876;2021;145
2007;82;56,13374;9,0217;1960;2007;47
2007;83;56,08339;8,98743;1972;2021;49
2007;116;55,87377;12,4726;1998;2011;13
2007;130;55,67057;11,18151;1899;2021;122
2007;171;55,48663;9,86367;1959;2008;49
2007;208;55,74166;11,41925;1865;2021;156
2007;210;56,40504;10,10971;2000;2021;21
2007;245;55,35164;11,32714;1938;2021;83
2007;263;56,32492;10,69459;2002;2021;19
2007;291;55,78719;8,25611;1985;2007;22
2007;299;55,77169;9,47224;1960;2021;61
2007;335;57,04003;10,01645;1982;2021;39
2008;3;55,412663;10,12987;1970;2011;41
2008;5;55,146277;10,020784;1995;2012;17
2008;6;55,269626;10,11524;1877;2009;132
2008;17;57,277261;9,94587;1986;2021;35
2008;35;55,3225039;11,9608428;1920;2010;90
2008;38;55,973541;12,534777;1946;2021;75
2008;40;55,522881;9,709432;2004;2021;17
2008;46;57,623216;10,430582;1985;2011;26
2008;50;55,8569401;12,0706508;1985;2010;25
2008;55;55,242371;10,53961;1866;2021;155
2008;64;54,689732;11,964726;1971;2021;50
2008;73;55,84433;9,589121;1848;2021;173
2008;77;56,028439;12,589834;1921;2021;100
2008;79;56,051014;12,584655;1969;2008;39
2008;87;55,941434;12,268503;1937;2021;84
2008;88;55,944946;12,309925;1923;2021;98
2008;93;57,356497;9,936222;1890;2021;131
2008;95;55,704063;11,690361;1963;2021;58
2008;121;55,9653067;9,094499;1993;2021;28
2008;122;56,148673;9,142385;1994;2021;27
2008;135;55,482156;9,451854;1949;2021;72
2008;144;55,673798;12,577517;1891;2021;130
2008;145;55,682456;12,569828;1877;2021;144
2008;154;56,520745;8,460418;2007;2021;14
2008;156;56,546487;8,414392;1971;2021;50
2008;165;56,6472378;9,970264;1954;2021;67
2008;169;55,490971;9,972686;1986;2021;35
2008;183;56,410263;10,747305;1996;2015;19
2008;187;55,548046;10,108677;2005;2021;16
2008;194;55,92104;10,25164;1956;2021;65
2008;195;55,9775064;10,1756177;1890;2021;131
2008;196;55,991623;10,251408;1972;2015;43
2008;204;55,837896;11,551628;1991;2021;30
2008;207;55,960508;11,749297;1980;2015;35
2008;215;56,886164;9,836899;1886;2009;123
2008;217;56,06639;8,314841;1969;2021;52
2008;225;55,801472;10,556744;1984;2012;28
2008;229;56,171178;9,556222;2006;2014;8
2008;230;56,178325;9,590822;1971;2021;50
2008;236;56,090396;9,758625;1892;2021;129
2008;239;56,572888;9,051158;1907;2021;114
2008;256;55,070962;10,511664;1920;2021;101
2008;258;55,1225643;10,7284368;1989;2021;32
2008;262;56,193792;10,691846;1993;2021;28
2008;265;56,279076;10,501631;2002;2012;10
2008;270;56,302138;10,477471;1894;2021;127
2008;273;54,898325;9,802925;1952;2021;69
2008;283;55,054318;8,950471;1960;2021;61
2008;285;55,1913926;9,066302;1984;2021;37
2008;294;55,471013;9,099652;1865;2021;156
2008;301;55,643464;9,651961;1889;2021;132
2008;302;55,715222;9,319221;1940;2021;81
2008;307;55,716877;9,585268;1943;2021;78
2008;314;56,377182;9,64424;1972;2021;49
2008;315;56,552152;9,40118;1868;2021;153
2008;316;56,441433;9,422904;1951;2021;70
2008;322;54,9748134;12,2737822;1866;2021;155
2008;324;54,924137;10,278204;1985;2021;36
2008;325;54,889128;10,412794;1978;2011;33
2008;327;55,030253;9,419819;1993;2020;27
2008;328;54,873518;9,518945;1921;2021;100
2008;339;56,214752;10,27358;1970;2021;51
2008;342;56,1956788;10,2204946;1970;2021;51
2008;343;56,101781;10,070482;1971;2011;40
2008;346;56,067076;10,134812;1866;2021;155
2008;13;55,18902;14,96054;1867;2021;154
2008;23;55,48022;8,43888;1910;2012;102
2008;26;55,28979;8,68128;1970;2021;51
2008;29;56,328077;10,04661;1876;2021;145
2008;83;56,08339;8,98743;1972;2021;49
2008;116;55,87377;12,4726;1998;2011;13
2008;130;55,67057;11,18151;1899;2021;122
2008;171;55,48663;9,86367;1959;2008;49
2008;208;55,74166;11,41925;1865;2021;156
2008;210;56,40504;10,10971;2000;2021;21
2008;245;55,35164;11,32714;1938;2021;83
2008;263;56,32492;10,69459;2002;2021;19
2008;299;55,77169;9,47224;1960;2021;61
2008;335;57,04003;10,01645;1982;2021;39
2009;3;55,412663;10,12987;1970;2011;41
2009;5;55,146277;10,020784;1995;2012;17
2009;6;55,269626;10,11524;1877;2009;132
2009;17;57,277261;9,94587;1986;2021;35
2009;35;55,3225039;11,9608428;1920;2010;90
2009;38;55,973541;12,534777;1946;2021;75
2009;40;55,522881;9,709432;2004;2021;17
2009;46;57,623216;10,430582;1985;2011;26
2009;50;55,8569401;12,0706508;1985;2010;25
2009;55;55,242371;10,53961;1866;2021;155
2009;64;54,689732;11,964726;1971;2021;50
2009;73;55,84433;9,589121;1848;2021;173
2009;77;56,028439;12,589834;1921;2021;100
2009;87;55,941434;12,268503;1937;2021;84
2009;88;55,944946;12,309925;1923;2021;98
2009;93;57,356497;9,936222;1890;2021;131
2009;95;55,704063;11,690361;1963;2021;58
2009;121;55,9653067;9,094499;1993;2021;28
2009;122;56,148673;9,142385;1994;2021;27
2009;135;55,482156;9,451854;1949;2021;72
2009;144;55,673798;12,577517;1891;2021;130
2009;145;55,682456;12,569828;1877;2021;144
2009;154;56,520745;8,460418;2007;2021;14
2009;156;56,546487;8,414392;1971;2021;50
2009;165;56,6472378;9,970264;1954;2021;67
2009;169;55,490971;9,972686;1986;2021;35
2009;183;56,410263;10,747305;1996;2015;19
2009;187;55,548046;10,108677;2005;2021;16
2009;194;55,92104;10,25164;1956;2021;65
2009;195;55,9775064;10,1756177;1890;2021;131
2009;196;55,991623;10,251408;1972;2015;43
2009;204;55,837896;11,551628;1991;2021;30
2009;207;55,960508;11,749297;1980;2015;35
2009;215;56,886164;9,836899;1886;2009;123
2009;217;56,06639;8,314841;1969;2021;52
2009;225;55,801472;10,556744;1984;2012;28
2009;229;56,171178;9,556222;2006;2014;8
2009;230;56,178325;9,590822;1971;2021;50
2009;236;56,090396;9,758625;1892;2021;129
2009;239;56,572888;9,051158;1907;2021;114
2009;256;55,070962;10,511664;1920;2021;101
2009;258;55,1225643;10,7284368;1989;2021;32
2009;262;56,193792;10,691846;1993;2021;28
2009;265;56,279076;10,501631;2002;2012;10
2009;270;56,302138;10,477471;1894;2021;127
2009;273;54,898325;9,802925;1952;2021;69
2009;283;55,054318;8,950471;1960;2021;61
2009;285;55,1913926;9,066302;1984;2021;37
2009;294;55,471013;9,099652;1865;2021;156
2009;301;55,643464;9,651961;1889;2021;132
2009;302;55,715222;9,319221;1940;2021;81
2009;307;55,716877;9,585268;1943;2021;78
2009;314;56,377182;9,64424;1972;2021;49
2009;315;56,552152;9,40118;1868;2021;153
2009;316;56,441433;9,422904;1951;2021;70
2009;320;55,132722;12,008426;2009;2021;12
2009;322;54,9748134;12,2737822;1866;2021;155
2009;324;54,924137;10,278204;1985;2021;36
2009;325;54,889128;10,412794;1978;2011;33
2009;327;55,030253;9,419819;1993;2020;27
2009;328;54,873518;9,518945;1921;2021;100
2009;339;56,214752;10,27358;1970;2021;51
2009;342;56,1956788;10,2204946;1970;2021;51
2009;343;56,101781;10,070482;1971;2011;40
2009;346;56,067076;10,134812;1866;2021;155
2009;13;55,18902;14,96054;1867;2021;154
2009;23;55,48022;8,43888;1910;2012;102
2009;26;55,28979;8,68128;1970;2021;51
2009;29;56,328077;10,04661;1876;2021;145
2009;83;56,08339;8,98743;1972;2021;49
2009;116;55,87377;12,4726;1998;2011;13
2009;130;55,67057;11,18151;1899;2021;122
2009;208;55,74166;11,41925;1865;2021;156
2009;210;56,40504;10,10971;2000;2021;21
2009;245;55,35164;11,32714;1938;2021;83
2009;263;56,32492;10,69459;2002;2021;19
2009;299;55,77169;9,47224;1960;2021;61
2009;335;57,04003;10,01645;1982;2021;39
2010;3;55,412663;10,12987;1970;2011;41
2010;5;55,146277;10,020784;1995;2012;17
2010;17;57,277261;9,94587;1986;2021;35
2010;35;55,3225039;11,9608428;1920;2010;90
2010;38;55,973541;12,534777;1946;2021;75
2010;40;55,522881;9,709432;2004;2021;17
2010;46;57,623216;10,430582;1985;2011;26
2010;50;55,8569401;12,0706508;1985;2010;25
2010;55;55,242371;10,53961;1866;2021;155
2010;64;54,689732;11,964726;1971;2021;50
2010;73;55,84433;9,589121;1848;2021;173
2010;77;56,028439;12,589834;1921;2021;100
2010;87;55,941434;12,268503;1937;2021;84
2010;88;55,944946;12,309925;1923;2021;98
2010;93;57,356497;9,936222;1890;2021;131
2010;95;55,704063;11,690361;1963;2021;58
2010;121;55,9653067;9,094499;1993;2021;28
2010;122;56,148673;9,142385;1994;2021;27
2010;135;55,482156;9,451854;1949;2021;72
2010;144;55,673798;12,577517;1891;2021;130
2010;145;55,682456;12,569828;1877;2021;144
2010;154;56,520745;8,460418;2007;2021;14
2010;156;56,546487;8,414392;1971;2021;50
2010;165;56,6472378;9,970264;1954;2021;67
2010;169;55,490971;9,972686;1986;2021;35
2010;183;56,410263;10,747305;1996;2015;19
2010;187;55,548046;10,108677;2005;2021;16
2010;194;55,92104;10,25164;1956;2021;65
2010;195;55,9775064;10,1756177;1890;2021;131
2010;196;55,991623;10,251408;1972;2015;43
2010;204;55,837896;11,551628;1991;2021;30
2010;207;55,960508;11,749297;1980;2015;35
2010;217;56,06639;8,314841;1969;2021;52
2010;225;55,801472;10,556744;1984;2012;28
2010;229;56,171178;9,556222;2006;2014;8
2010;230;56,178325;9,590822;1971;2021;50
2010;236;56,090396;9,758625;1892;2021;129
2010;239;56,572888;9,051158;1907;2021;114
2010;256;55,070962;10,511664;1920;2021;101
2010;258;55,1225643;10,7284368;1989;2021;32
2010;262;56,193792;10,691846;1993;2021;28
2010;265;56,279076;10,501631;2002;2012;10
2010;270;56,302138;10,477471;1894;2021;127
2010;273;54,898325;9,802925;1952;2021;69
2010;283;55,054318;8,950471;1960;2021;61
2010;285;55,1913926;9,066302;1984;2021;37
2010;294;55,471013;9,099652;1865;2021;156
2010;301;55,643464;9,651961;1889;2021;132
2010;302;55,715222;9,319221;1940;2021;81
2010;307;55,716877;9,585268;1943;2021;78
2010;314;56,377182;9,64424;1972;2021;49
2010;315;56,552152;9,40118;1868;2021;153
2010;316;56,441433;9,422904;1951;2021;70
2010;320;55,132722;12,008426;2009;2021;12
2010;322;54,9748134;12,2737822;1866;2021;155
2010;324;54,924137;10,278204;1985;2021;36
2010;325;54,889128;10,412794;1978;2011;33
2010;327;55,030253;9,419819;1993;2020;27
2010;328;54,873518;9,518945;1921;2021;100
2010;339;56,214752;10,27358;1970;2021;51
2010;342;56,1956788;10,2204946;1970;2021;51
2010;343;56,101781;10,070482;1971;2011;40
2010;346;56,067076;10,134812;1866;2021;155
2010;13;55,18902;14,96054;1867;2021;154
2010;23;55,48022;8,43888;1910;2012;102
2010;26;55,28979;8,68128;1970;2021;51
2010;29;56,328077;10,04661;1876;2021;145
2010;83;56,08339;8,98743;1972;2021;49
2010;116;55,87377;12,4726;1998;2011;13
2010;130;55,67057;11,18151;1899;2021;122
2010;208;55,74166;11,41925;1865;2021;156
2010;210;56,40504;10,10971;2000;2021;21
2010;245;55,35164;11,32714;1938;2021;83
2010;263;56,32492;10,69459;2002;2021;19
2010;299;55,77169;9,47224;1960;2021;61
2010;335;57,04003;10,01645;1982;2021;39
2011;3;55,412663;10,12987;1970;2011;41
2011;5;55,146277;10,020784;1995;2012;17
2011;17;57,277261;9,94587;1986;2021;35
2011;38;55,973541;12,534777;1946;2021;75
2011;40;55,522881;9,709432;2004;2021;17
2011;46;57,623216;10,430582;1985;2011;26
2011;55;55,242371;10,53961;1866;2021;155
2011;64;54,689732;11,964726;1971;2021;50
2011;73;55,84433;9,589121;1848;2021;173
2011;77;56,028439;12,589834;1921;2021;100
2011;87;55,941434;12,268503;1937;2021;84
2011;88;55,944946;12,309925;1923;2021;98
2011;93;57,356497;9,936222;1890;2021;131
2011;95;55,704063;11,690361;1963;2021;58
2011;121;55,9653067;9,094499;1993;2021;28
2011;122;56,148673;9,142385;1994;2021;27
2011;135;55,482156;9,451854;1949;2021;72
2011;144;55,673798;12,577517;1891;2021;130
2011;145;55,682456;12,569828;1877;2021;144
2011;147;55,682258;12,575122;2011;2021;10
2011;154;56,520745;8,460418;2007;2021;14
2011;156;56,546487;8,414392;1971;2021;50
2011;165;56,6472378;9,970264;1954;2021;67
2011;169;55,490971;9,972686;1986;2021;35
2011;183;56,410263;10,747305;1996;2015;19
2011;187;55,548046;10,108677;2005;2021;16
2011;194;55,92104;10,25164;1956;2021;65
2011;195;55,9775064;10,1756177;1890;2021;131
2011;196;55,991623;10,251408;1972;2015;43
2011;204;55,837896;11,551628;1991;2021;30
2011;207;55,960508;11,749297;1980;2015;35
2011;217;56,06639;8,314841;1969;2021;52
2011;225;55,801472;10,556744;1984;2012;28
2011;229;56,171178;9,556222;2006;2014;8
2011;230;56,178325;9,590822;1971;2021;50
2011;236;56,090396;9,758625;1892;2021;129
2011;239;56,572888;9,051158;1907;2021;114
2011;256;55,070962;10,511664;1920;2021;101
2011;258;55,1225643;10,7284368;1989;2021;32
2011;262;56,193792;10,691846;1993;2021;28
2011;265;56,279076;10,501631;2002;2012;10
2011;270;56,302138;10,477471;1894;2021;127
2011;273;54,898325;9,802925;1952;2021;69
2011;283;55,054318;8,950471;1960;2021;61
2011;285;55,1913926;9,066302;1984;2021;37
2011;294;55,471013;9,099652;1865;2021;156
2011;301;55,643464;9,651961;1889;2021;132
2011;302;55,715222;9,319221;1940;2021;81
2011;307;55,716877;9,585268;1943;2021;78
2011;314;56,377182;9,64424;1972;2021;49
2011;315;56,552152;9,40118;1868;2021;153
2011;316;56,441433;9,422904;1951;2021;70
2011;320;55,132722;12,008426;2009;2021;12
2011;322;54,9748134;12,2737822;1866;2021;155
2011;324;54,924137;10,278204;1985;2021;36
2011;325;54,889128;10,412794;1978;2011;33
2011;327;55,030253;9,419819;1993;2020;27
2011;328;54,873518;9,518945;1921;2021;100
2011;339;56,214752;10,27358;1970;2021;51
2011;342;56,1956788;10,2204946;1970;2021;51
2011;343;56,101781;10,070482;1971;2011;40
2011;346;56,067076;10,134812;1866;2021;155
2011;13;55,18902;14,96054;1867;2021;154
2011;23;55,48022;8,43888;1910;2012;102
2011;26;55,28979;8,68128;1970;2021;51
2011;29;56,328077;10,04661;1876;2021;145
2011;83;56,08339;8,98743;1972;2021;49
2011;116;55,87377;12,4726;1998;2011;13
2011;130;55,67057;11,18151;1899;2021;122
2011;208;55,74166;11,41925;1865;2021;156
2011;210;56,40504;10,10971;2000;2021;21
2011;245;55,35164;11,32714;1938;2021;83
2011;263;56,32492;10,69459;2002;2021;19
2011;299;55,77169;9,47224;1960;2021;61
2011;335;57,04003;10,01645;1982;2021;39
2012;5;55,146277;10,020784;1995;2012;17
2012;17;57,277261;9,94587;1986;2021;35
2012;38;55,973541;12,534777;1946;2021;75
2012;40;55,522881;9,709432;2004;2021;17
2012;55;55,242371;10,53961;1866;2021;155
2012;64;54,689732;11,964726;1971;2021;50
2012;73;55,84433;9,589121;1848;2021;173
2012;77;56,028439;12,589834;1921;2021;100
2012;87;55,941434;12,268503;1937;2021;84
2012;88;55,944946;12,309925;1923;2021;98
2012;93;57,356497;9,936222;1890;2021;131
2012;95;55,704063;11,690361;1963;2021;58
2012;121;55,9653067;9,094499;1993;2021;28
2012;122;56,148673;9,142385;1994;2021;27
2012;135;55,482156;9,451854;1949;2021;72
2012;144;55,673798;12,577517;1891;2021;130
2012;145;55,682456;12,569828;1877;2021;144
2012;147;55,682258;12,575122;2011;2021;10
2012;154;56,520745;8,460418;2007;2021;14
2012;156;56,546487;8,414392;1971;2021;50
2012;165;56,6472378;9,970264;1954;2021;67
2012;169;55,490971;9,972686;1986;2021;35
2012;183;56,410263;10,747305;1996;2015;19
2012;187;55,548046;10,108677;2005;2021;16
2012;194;55,92104;10,25164;1956;2021;65
2012;195;55,9775064;10,1756177;1890;2021;131
2012;196;55,991623;10,251408;1972;2015;43
2012;204;55,837896;11,551628;1991;2021;30
2012;207;55,960508;11,749297;1980;2015;35
2012;217;56,06639;8,314841;1969;2021;52
2012;225;55,801472;10,556744;1984;2012;28
2012;229;56,171178;9,556222;2006;2014;8
2012;230;56,178325;9,590822;1971;2021;50
2012;236;56,090396;9,758625;1892;2021;129
2012;239;56,572888;9,051158;1907;2021;114
2012;256;55,070962;10,511664;1920;2021;101
2012;258;55,1225643;10,7284368;1989;2021;32
2012;262;56,193792;10,691846;1993;2021;28
2012;265;56,279076;10,501631;2002;2012;10
2012;270;56,302138;10,477471;1894;2021;127
2012;273;54,898325;9,802925;1952;2021;69
2012;283;55,054318;8,950471;1960;2021;61
2012;285;55,1913926;9,066302;1984;2021;37
2012;294;55,471013;9,099652;1865;2021;156
2012;301;55,643464;9,651961;1889;2021;132
2012;302;55,715222;9,319221;1940;2021;81
2012;307;55,716877;9,585268;1943;2021;78
2012;314;56,377182;9,64424;1972;2021;49
2012;315;56,552152;9,40118;1868;2021;153
2012;316;56,441433;9,422904;1951;2021;70
2012;320;55,132722;12,008426;2009;2021;12
2012;322;54,9748134;12,2737822;1866;2021;155
2012;324;54,924137;10,278204;1985;2021;36
2012;327;55,030253;9,419819;1993;2020;27
2012;328;54,873518;9,518945;1921;2021;100
2012;339;56,214752;10,27358;1970;2021;51
2012;342;56,1956788;10,2204946;1970;2021;51
2012;346;56,067076;10,134812;1866;2021;155
2012;13;55,18902;14,96054;1867;2021;154
2012;23;55,48022;8,43888;1910;2012;102
2012;26;55,28979;8,68128;1970;2021;51
2012;29;56,328077;10,04661;1876;2021;145
2012;83;56,08339;8,98743;1972;2021;49
2012;130;55,67057;11,18151;1899;2021;122
2012;208;55,74166;11,41925;1865;2021;156
2012;210;56,40504;10,10971;2000;2021;21
2012;245;55,35164;11,32714;1938;2021;83
2012;263;56,32492;10,69459;2002;2021;19
2012;299;55,77169;9,47224;1960;2021;61
2012;335;57,04003;10,01645;1982;2021;39
2013;17;57,277261;9,94587;1986;2021;35
2013;38;55,973541;12,534777;1946;2021;75
2013;40;55,522881;9,709432;2004;2021;17
2013;55;55,242371;10,53961;1866;2021;155
2013;64;54,689732;11,964726;1971;2021;50
2013;73;55,84433;9,589121;1848;2021;173
2013;77;56,028439;12,589834;1921;2021;100
2013;87;55,941434;12,268503;1937;2021;84
2013;88;55,944946;12,309925;1923;2021;98
2013;93;57,356497;9,936222;1890;2021;131
2013;95;55,704063;11,690361;1963;2021;58
2013;121;55,9653067;9,094499;1993;2021;28
2013;122;56,148673;9,142385;1994;2021;27
2013;135;55,482156;9,451854;1949;2021;72
2013;144;55,673798;12,577517;1891;2021;130
2013;145;55,682456;12,569828;1877;2021;144
2013;147;55,682258;12,575122;2011;2021;10
2013;154;56,520745;8,460418;2007;2021;14
2013;156;56,546487;8,414392;1971;2021;50
2013;165;56,6472378;9,970264;1954;2021;67
2013;169;55,490971;9,972686;1986;2021;35
2013;183;56,410263;10,747305;1996;2015;19
2013;187;55,548046;10,108677;2005;2021;16
2013;194;55,92104;10,25164;1956;2021;65
2013;195;55,9775064;10,1756177;1890;2021;131
2013;196;55,991623;10,251408;1972;2015;43
2013;204;55,837896;11,551628;1991;2021;30
2013;207;55,960508;11,749297;1980;2015;35
2013;217;56,06639;8,314841;1969;2021;52
2013;229;56,171178;9,556222;2006;2014;8
2013;230;56,178325;9,590822;1971;2021;50
2013;236;56,090396;9,758625;1892;2021;129
2013;239;56,572888;9,051158;1907;2021;114
2013;256;55,070962;10,511664;1920;2021;101
2013;258;55,1225643;10,7284368;1989;2021;32
2013;262;56,193792;10,691846;1993;2021;28
2013;270;56,302138;10,477471;1894;2021;127
2013;273;54,898325;9,802925;1952;2021;69
2013;283;55,054318;8,950471;1960;2021;61
2013;285;55,1913926;9,066302;1984;2021;37
2013;294;55,471013;9,099652;1865;2021;156
2013;301;55,643464;9,651961;1889;2021;132
2013;302;55,715222;9,319221;1940;2021;81
2013;307;55,716877;9,585268;1943;2021;78
2013;314;56,377182;9,64424;1972;2021;49
2013;315;56,552152;9,40118;1868;2021;153
2013;316;56,441433;9,422904;1951;2021;70
2013;320;55,132722;12,008426;2009;2021;12
2013;322;54,9748134;12,2737822;1866;2021;155
2013;324;54,924137;10,278204;1985;2021;36
2013;327;55,030253;9,419819;1993;2020;27
2013;328;54,873518;9,518945;1921;2021;100
2013;339;56,214752;10,27358;1970;2021;51
2013;342;56,1956788;10,2204946;1970;2021;51
2013;346;56,067076;10,134812;1866;2021;155
2013;13;55,18902;14,96054;1867;2021;154
2013;26;55,28979;8,68128;1970;2021;51
2013;29;56,328077;10,04661;1876;2021;145
2013;83;56,08339;8,98743;1972;2021;49
2013;130;55,67057;11,18151;1899;2021;122
2013;208;55,74166;11,41925;1865;2021;156
2013;210;56,40504;10,10971;2000;2021;21
2013;245;55,35164;11,32714;1938;2021;83
2013;263;56,32492;10,69459;2002;2021;19
2013;299;55,77169;9,47224;1960;2021;61
2013;335;57,04003;10,01645;1982;2021;39
2014;17;57,277261;9,94587;1986;2021;35
2014;38;55,973541;12,534777;1946;2021;75
2014;40;55,522881;9,709432;2004;2021;17
2014;55;55,242371;10,53961;1866;2021;155
2014;64;54,689732;11,964726;1971;2021;50
2014;73;55,84433;9,589121;1848;2021;173
2014;77;56,028439;12,589834;1921;2021;100
2014;87;55,941434;12,268503;1937;2021;84
2014;88;55,944946;12,309925;1923;2021;98
2014;93;57,356497;9,936222;1890;2021;131
2014;94;55,659832;11,393806;2014;2021;7
2014;95;55,704063;11,690361;1963;2021;58
2014;121;55,9653067;9,094499;1993;2021;28
2014;122;56,148673;9,142385;1994;2021;27
2014;135;55,482156;9,451854;1949;2021;72
2014;144;55,673798;12,577517;1891;2021;130
2014;145;55,682456;12,569828;1877;2021;144
2014;147;55,682258;12,575122;2011;2021;10
2014;154;56,520745;8,460418;2007;2021;14
2014;156;56,546487;8,414392;1971;2021;50
2014;165;56,6472378;9,970264;1954;2021;67
2014;169;55,490971;9,972686;1986;2021;35
2014;183;56,410263;10,747305;1996;2015;19
2014;187;55,548046;10,108677;2005;2021;16
2014;194;55,92104;10,25164;1956;2021;65
2014;195;55,9775064;10,1756177;1890;2021;131
2014;196;55,991623;10,251408;1972;2015;43
2014;204;55,837896;11,551628;1991;2021;30
2014;207;55,960508;11,749297;1980;2015;35
2014;217;56,06639;8,314841;1969;2021;52
2014;229;56,171178;9,556222;2006;2014;8
2014;230;56,178325;9,590822;1971;2021;50
2014;236;56,090396;9,758625;1892;2021;129
2014;239;56,572888;9,051158;1907;2021;114
2014;256;55,070962;10,511664;1920;2021;101
2014;258;55,1225643;10,7284368;1989;2021;32
2014;262;56,193792;10,691846;1993;2021;28
2014;270;56,302138;10,477471;1894;2021;127
2014;273;54,898325;9,802925;1952;2021;69
2014;283;55,054318;8,950471;1960;2021;61
2014;285;55,1913926;9,066302;1984;2021;37
2014;294;55,471013;9,099652;1865;2021;156
2014;301;55,643464;9,651961;1889;2021;132
2014;302;55,715222;9,319221;1940;2021;81
2014;307;55,716877;9,585268;1943;2021;78
2014;314;56,377182;9,64424;1972;2021;49
2014;315;56,552152;9,40118;1868;2021;153
2014;316;56,441433;9,422904;1951;2021;70
2014;320;55,132722;12,008426;2009;2021;12
2014;322;54,9748134;12,2737822;1866;2021;155
2014;324;54,924137;10,278204;1985;2021;36
2014;327;55,030253;9,419819;1993;2020;27
2014;328;54,873518;9,518945;1921;2021;100
2014;339;56,214752;10,27358;1970;2021;51
2014;342;56,1956788;10,2204946;1970;2021;51
2014;346;56,067076;10,134812;1866;2021;155
2014;13;55,18902;14,96054;1867;2021;154
2014;26;55,28979;8,68128;1970;2021;51
2014;29;56,328077;10,04661;1876;2021;145
2014;83;56,08339;8,98743;1972;2021;49
2014;130;55,67057;11,18151;1899;2021;122
2014;208;55,74166;11,41925;1865;2021;156
2014;210;56,40504;10,10971;2000;2021;21
2014;245;55,35164;11,32714;1938;2021;83
2014;263;56,32492;10,69459;2002;2021;19
2014;299;55,77169;9,47224;1960;2021;61
2014;335;57,04003;10,01645;1982;2021;39
2015;17;57,277261;9,94587;1986;2021;35
2015;38;55,973541;12,534777;1946;2021;75
2015;40;55,522881;9,709432;2004;2021;17
2015;55;55,242371;10,53961;1866;2021;155
2015;64;54,689732;11,964726;1971;2021;50
2015;73;55,84433;9,589121;1848;2021;173
2015;77;56,028439;12,589834;1921;2021;100
2015;87;55,941434;12,268503;1937;2021;84
2015;88;55,944946;12,309925;1923;2021;98
2015;93;57,356497;9,936222;1890;2021;131
2015;94;55,659832;11,393806;2014;2021;7
2015;95;55,704063;11,690361;1963;2021;58
2015;121;55,9653067;9,094499;1993;2021;28
2015;122;56,148673;9,142385;1994;2021;27
2015;135;55,482156;9,451854;1949;2021;72
2015;144;55,673798;12,577517;1891;2021;130
2015;145;55,682456;12,569828;1877;2021;144
2015;147;55,682258;12,575122;2011;2021;10
2015;154;56,520745;8,460418;2007;2021;14
2015;156;56,546487;8,414392;1971;2021;50
2015;165;56,6472378;9,970264;1954;2021;67
2015;169;55,490971;9,972686;1986;2021;35
2015;183;56,410263;10,747305;1996;2015;19
2015;187;55,548046;10,108677;2005;2021;16
2015;194;55,92104;10,25164;1956;2021;65
2015;195;55,9775064;10,1756177;1890;2021;131
2015;196;55,991623;10,251408;1972;2015;43
2015;204;55,837896;11,551628;1991;2021;30
2015;207;55,960508;11,749297;1980;2015;35
2015;217;56,06639;8,314841;1969;2021;52
2015;230;56,178325;9,590822;1971;2021;50
2015;236;56,090396;9,758625;1892;2021;129
2015;239;56,572888;9,051158;1907;2021;114
2015;256;55,070962;10,511664;1920;2021;101
2015;258;55,1225643;10,7284368;1989;2021;32
2015;262;56,193792;10,691846;1993;2021;28
2015;270;56,302138;10,477471;1894;2021;127
2015;273;54,898325;9,802925;1952;2021;69
2015;283;55,054318;8,950471;1960;2021;61
2015;285;55,1913926;9,066302;1984;2021;37
2015;294;55,471013;9,099652;1865;2021;156
2015;301;55,643464;9,651961;1889;2021;132
2015;302;55,715222;9,319221;1940;2021;81
2015;307;55,716877;9,585268;1943;2021;78
2015;314;56,377182;9,64424;1972;2021;49
2015;315;56,552152;9,40118;1868;2021;153
2015;316;56,441433;9,422904;1951;2021;70
2015;320;55,132722;12,008426;2009;2021;12
2015;322;54,9748134;12,2737822;1866;2021;155
2015;324;54,924137;10,278204;1985;2021;36
2015;327;55,030253;9,419819;1993;2020;27
2015;328;54,873518;9,518945;1921;2021;100
2015;339;56,214752;10,27358;1970;2021;51
2015;342;56,1956788;10,2204946;1970;2021;51
2015;346;56,067076;10,134812;1866;2021;155
2015;13;55,18902;14,96054;1867;2021;154
2015;26;55,28979;8,68128;1970;2021;51
2015;29;56,328077;10,04661;1876;2021;145
2015;83;56,08339;8,98743;1972;2021;49
2015;130;55,67057;11,18151;1899;2021;122
2015;208;55,74166;11,41925;1865;2021;156
2015;210;56,40504;10,10971;2000;2021;21
2015;245;55,35164;11,32714;1938;2021;83
2015;263;56,32492;10,69459;2002;2021;19
2015;299;55,77169;9,47224;1960;2021;61
2015;335;57,04003;10,01645;1982;2021;39
2016;17;57,277261;9,94587;1986;2021;35
2016;38;55,973541;12,534777;1946;2021;75
2016;40;55,522881;9,709432;2004;2021;17
2016;55;55,242371;10,53961;1866;2021;155
2016;64;54,689732;11,964726;1971;2021;50
2016;73;55,84433;9,589121;1848;2021;173
2016;77;56,028439;12,589834;1921;2021;100
2016;87;55,941434;12,268503;1937;2021;84
2016;88;55,944946;12,309925;1923;2021;98
2016;93;57,356497;9,936222;1890;2021;131
2016;94;55,659832;11,393806;2014;2021;7
2016;95;55,704063;11,690361;1963;2021;58
2016;121;55,9653067;9,094499;1993;2021;28
2016;122;56,148673;9,142385;1994;2021;27
2016;127;55,752999;11,321096;2016;2021;5
2016;135;55,482156;9,451854;1949;2021;72
2016;144;55,673798;12,577517;1891;2021;130
2016;145;55,682456;12,569828;1877;2021;144
2016;147;55,682258;12,575122;2011;2021;10
2016;154;56,520745;8,460418;2007;2021;14
2016;156;56,546487;8,414392;1971;2021;50
2016;165;56,6472378;9,970264;1954;2021;67
2016;169;55,490971;9,972686;1986;2021;35
2016;187;55,548046;10,108677;2005;2021;16
2016;194;55,92104;10,25164;1956;2021;65
2016;195;55,9775064;10,1756177;1890;2021;131
2016;204;55,837896;11,551628;1991;2021;30
2016;217;56,06639;8,314841;1969;2021;52
2016;230;56,178325;9,590822;1971;2021;50
2016;236;56,090396;9,758625;1892;2021;129
2016;239;56,572888;9,051158;1907;2021;114
2016;256;55,070962;10,511664;1920;2021;101
2016;258;55,1225643;10,7284368;1989;2021;32
2016;262;56,193792;10,691846;1993;2021;28
2016;270;56,302138;10,477471;1894;2021;127
2016;273;54,898325;9,802925;1952;2021;69
2016;283;55,054318;8,950471;1960;2021;61
2016;285;55,1913926;9,066302;1984;2021;37
2016;294;55,471013;9,099652;1865;2021;156
2016;301;55,643464;9,651961;1889;2021;132
2016;302;55,715222;9,319221;1940;2021;81
2016;307;55,716877;9,585268;1943;2021;78
2016;314;56,377182;9,64424;1972;2021;49
2016;315;56,552152;9,40118;1868;2021;153
2016;316;56,441433;9,422904;1951;2021;70
2016;320;55,132722;12,008426;2009;2021;12
2016;322;54,9748134;12,2737822;1866;2021;155
2016;324;54,924137;10,278204;1985;2021;36
2016;327;55,030253;9,419819;1993;2020;27
2016;328;54,873518;9,518945;1921;2021;100
2016;339;56,214752;10,27358;1970;2021;51
2016;342;56,1956788;10,2204946;1970;2021;51
2016;346;56,067076;10,134812;1866;2021;155
2016;13;55,18902;14,96054;1867;2021;154
2016;26;55,28979;8,68128;1970;2021;51
2016;29;56,328077;10,04661;1876;2021;145
2016;83;56,08339;8,98743;1972;2021;49
2016;130;55,67057;11,18151;1899;2021;122
2016;208;55,74166;11,41925;1865;2021;156
2016;210;56,40504;10,10971;2000;2021;21
2016;245;55,35164;11,32714;1938;2021;83
2016;263;56,32492;10,69459;2002;2021;19
2016;299;55,77169;9,47224;1960;2021;61
2016;335;57,04003;10,01645;1982;2021;39
2017;17;57,277261;9,94587;1986;2021;35
2017;38;55,973541;12,534777;1946;2021;75
2017;40;55,522881;9,709432;2004;2021;17
2017;55;55,242371;10,53961;1866;2021;155
2017;64;54,689732;11,964726;1971;2021;50
2017;73;55,84433;9,589121;1848;2021;173
2017;77;56,028439;12,589834;1921;2021;100
2017;87;55,941434;12,268503;1937;2021;84
2017;88;55,944946;12,309925;1923;2021;98
2017;93;57,356497;9,936222;1890;2021;131
2017;94;55,659832;11,393806;2014;2021;7
2017;95;55,704063;11,690361;1963;2021;58
2017;121;55,9653067;9,094499;1993;2021;28
2017;122;56,148673;9,142385;1994;2021;27
2017;125;57,104458;9,125031;2017;2020;3
2017;127;55,752999;11,321096;2016;2021;5
2017;135;55,482156;9,451854;1949;2021;72
2017;144;55,673798;12,577517;1891;2021;130
2017;145;55,682456;12,569828;1877;2021;144
2017;147;55,682258;12,575122;2011;2021;10
2017;154;56,520745;8,460418;2007;2021;14
2017;156;56,546487;8,414392;1971;2021;50
2017;165;56,6472378;9,970264;1954;2021;67
2017;169;55,490971;9,972686;1986;2021;35
2017;187;55,548046;10,108677;2005;2021;16
2017;194;55,92104;10,25164;1956;2021;65
2017;195;55,9775064;10,1756177;1890;2021;131
2017;204;55,837896;11,551628;1991;2021;30
2017;217;56,06639;8,314841;1969;2021;52
2017;230;56,178325;9,590822;1971;2021;50
2017;236;56,090396;9,758625;1892;2021;129
2017;239;56,572888;9,051158;1907;2021;114
2017;256;55,070962;10,511664;1920;2021;101
2017;258;55,1225643;10,7284368;1989;2021;32
2017;262;56,193792;10,691846;1993;2021;28
2017;270;56,302138;10,477471;1894;2021;127
2017;273;54,898325;9,802925;1952;2021;69
2017;283;55,054318;8,950471;1960;2021;61
2017;285;55,1913926;9,066302;1984;2021;37
2017;294;55,471013;9,099652;1865;2021;156
2017;301;55,643464;9,651961;1889;2021;132
2017;302;55,715222;9,319221;1940;2021;81
2017;307;55,716877;9,585268;1943;2021;78
2017;313;56,411417;9,346793;2017;2018;1
2017;314;56,377182;9,64424;1972;2021;49
2017;315;56,552152;9,40118;1868;2021;153
2017;316;56,441433;9,422904;1951;2021;70
2017;319;54,9870148;12,2867744;2017;2021;4
2017;320;55,132722;12,008426;2009;2021;12
2017;322;54,9748134;12,2737822;1866;2021;155
2017;324;54,924137;10,278204;1985;2021;36
2017;327;55,030253;9,419819;1993;2020;27
2017;328;54,873518;9,518945;1921;2021;100
2017;339;56,214752;10,27358;1970;2021;51
2017;342;56,1956788;10,2204946;1970;2021;51
2017;346;56,067076;10,134812;1866;2021;155
2017;13;55,18902;14,96054;1867;2021;154
2017;26;55,28979;8,68128;1970;2021;51
2017;29;56,328077;10,04661;1876;2021;145
2017;83;56,08339;8,98743;1972;2021;49
2017;130;55,67057;11,18151;1899;2021;122
2017;208;55,74166;11,41925;1865;2021;156
2017;210;56,40504;10,10971;2000;2021;21
2017;245;55,35164;11,32714;1938;2021;83
2017;263;56,32492;10,69459;2002;2021;19
2017;299;55,77169;9,47224;1960;2021;61
2017;335;57,04003;10,01645;1982;2021;39
2018;17;57,277261;9,94587;1986;2021;35
2018;38;55,973541;12,534777;1946;2021;75
2018;40;55,522881;9,709432;2004;2021;17
2018;55;55,242371;10,53961;1866;2021;155
2018;64;54,689732;11,964726;1971;2021;50
2018;73;55,84433;9,589121;1848;2021;173
2018;77;56,028439;12,589834;1921;2021;100
2018;87;55,941434;12,268503;1937;2021;84
2018;88;55,944946;12,309925;1923;2021;98
2018;93;57,356497;9,936222;1890;2021;131
2018;94;55,659832;11,393806;2014;2021;7
2018;95;55,704063;11,690361;1963;2021;58
2018;121;55,9653067;9,094499;1993;2021;28
2018;122;56,148673;9,142385;1994;2021;27
2018;125;57,104458;9,125031;2017;2020;3
2018;127;55,752999;11,321096;2016;2021;5
2018;135;55,482156;9,451854;1949;2021;72
2018;144;55,673798;12,577517;1891;2021;130
2018;145;55,682456;12,569828;1877;2021;144
2018;147;55,682258;12,575122;2011;2021;10
2018;154;56,520745;8,460418;2007;2021;14
2018;156;56,546487;8,414392;1971;2021;50
2018;165;56,6472378;9,970264;1954;2021;67
2018;169;55,490971;9,972686;1986;2021;35
2018;187;55,548046;10,108677;2005;2021;16
2018;194;55,92104;10,25164;1956;2021;65
2018;195;55,9775064;10,1756177;1890;2021;131
2018;204;55,837896;11,551628;1991;2021;30
2018;217;56,06639;8,314841;1969;2021;52
2018;230;56,178325;9,590822;1971;2021;50
2018;236;56,090396;9,758625;1892;2021;129
2018;239;56,572888;9,051158;1907;2021;114
2018;254;56,486889;8,584746;2018;2021;3
2018;256;55,070962;10,511664;1920;2021;101
2018;258;55,1225643;10,7284368;1989;2021;32
2018;262;56,193792;10,691846;1993;2021;28
2018;270;56,302138;10,477471;1894;2021;127
2018;273;54,898325;9,802925;1952;2021;69
2018;282;54,962084;8,694059;2018;2019;1
2018;283;55,054318;8,950471;1960;2021;61
2018;285;55,1913926;9,066302;1984;2021;37
2018;294;55,471013;9,099652;1865;2021;156
2018;301;55,643464;9,651961;1889;2021;132
2018;302;55,715222;9,319221;1940;2021;81
2018;307;55,716877;9,585268;1943;2021;78
2018;313;56,411417;9,346793;2017;2018;1
2018;314;56,377182;9,64424;1972;2021;49
2018;315;56,552152;9,40118;1868;2021;153
2018;316;56,441433;9,422904;1951;2021;70
2018;319;54,9870148;12,2867744;2017;2021;4
2018;320;55,132722;12,008426;2009;2021;12
2018;322;54,9748134;12,2737822;1866;2021;155
2018;324;54,924137;10,278204;1985;2021;36
2018;327;55,030253;9,419819;1993;2020;27
2018;328;54,873518;9,518945;1921;2021;100
2018;339;56,214752;10,27358;1970;2021;51
2018;342;56,1956788;10,2204946;1970;2021;51
2018;346;56,067076;10,134812;1866;2021;155
2018;13;55,18902;14,96054;1867;2021;154
2018;26;55,28979;8,68128;1970;2021;51
2018;29;56,328077;10,04661;1876;2021;145
2018;83;56,08339;8,98743;1972;2021;49
2018;130;55,67057;11,18151;1899;2021;122
2018;208;55,74166;11,41925;1865;2021;156
2018;210;56,40504;10,10971;2000;2021;21
2018;245;55,35164;11,32714;1938;2021;83
2018;263;56,32492;10,69459;2002;2021;19
2018;299;55,77169;9,47224;1960;2021;61
2018;335;57,04003;10,01645;1982;2021;39
2019;17;57,277261;9,94587;1986;2021;35
2019;38;55,973541;12,534777;1946;2021;75
2019;40;55,522881;9,709432;2004;2021;17
2019;55;55,242371;10,53961;1866;2021;155
2019;64;54,689732;11,964726;1971;2021;50
2019;73;55,84433;9,589121;1848;2021;173
2019;77;56,028439;12,589834;1921;2021;100
2019;87;55,941434;12,268503;1937;2021;84
2019;88;55,944946;12,309925;1923;2021;98
2019;93;57,356497;9,936222;1890;2021;131
2019;94;55,659832;11,393806;2014;2021;7
2019;95;55,704063;11,690361;1963;2021;58
2019;121;55,9653067;9,094499;1993;2021;28
2019;122;56,148673;9,142385;1994;2021;27
2019;125;57,104458;9,125031;2017;2020;3
2019;127;55,752999;11,321096;2016;2021;5
2019;135;55,482156;9,451854;1949;2021;72
2019;144;55,673798;12,577517;1891;2021;130
2019;145;55,682456;12,569828;1877;2021;144
2019;147;55,682258;12,575122;2011;2021;10
2019;154;56,520745;8,460418;2007;2021;14
2019;156;56,546487;8,414392;1971;2021;50
2019;165;56,6472378;9,970264;1954;2021;67
2019;169;55,490971;9,972686;1986;2021;35
2019;187;55,548046;10,108677;2005;2021;16
2019;194;55,92104;10,25164;1956;2021;65
2019;195;55,9775064;10,1756177;1890;2021;131
2019;204;55,837896;11,551628;1991;2021;30
2019;217;56,06639;8,314841;1969;2021;52
2019;220;55,627599;12,082505;2019;2021;2
2019;230;56,178325;9,590822;1971;2021;50
2019;236;56,090396;9,758625;1892;2021;129
2019;239;56,572888;9,051158;1907;2021;114
2019;254;56,486889;8,584746;2018;2021;3
2019;256;55,070962;10,511664;1920;2021;101
2019;258;55,1225643;10,7284368;1989;2021;32
2019;262;56,193792;10,691846;1993;2021;28
2019;270;56,302138;10,477471;1894;2021;127
2019;273;54,898325;9,802925;1952;2021;69
2019;282;54,962084;8,694059;2018;2019;1
2019;283;55,054318;8,950471;1960;2021;61
2019;285;55,1913926;9,066302;1984;2021;37
2019;294;55,471013;9,099652;1865;2021;156
2019;301;55,643464;9,651961;1889;2021;132
2019;302;55,715222;9,319221;1940;2021;81
2019;307;55,716877;9,585268;1943;2021;78
2019;314;56,377182;9,64424;1972;2021;49
2019;315;56,552152;9,40118;1868;2021;153
2019;316;56,441433;9,422904;1951;2021;70
2019;319;54,9870148;12,2867744;2017;2021;4
2019;320;55,132722;12,008426;2009;2021;12
2019;322;54,9748134;12,2737822;1866;2021;155
2019;324;54,924137;10,278204;1985;2021;36
2019;327;55,030253;9,419819;1993;2020;27
2019;328;54,873518;9,518945;1921;2021;100
2019;339;56,214752;10,27358;1970;2021;51
2019;342;56,1956788;10,2204946;1970;2021;51
2019;346;56,067076;10,134812;1866;2021;155
2019;13;55,18902;14,96054;1867;2021;154
2019;26;55,28979;8,68128;1970;2021;51
2019;29;56,328077;10,04661;1876;2021;145
2019;83;56,08339;8,98743;1972;2021;49
2019;130;55,67057;11,18151;1899;2021;122
2019;208;55,74166;11,41925;1865;2021;156
2019;210;56,40504;10,10971;2000;2021;21
2019;228;56,27438;9,3948;2019;2021;2
2019;245;55,35164;11,32714;1938;2021;83
2019;263;56,32492;10,69459;2002;2021;19
2019;299;55,77169;9,47224;1960;2021;61
2019;335;57,04003;10,01645;1982;2021;39
2020;17;57,277261;9,94587;1986;2021;35
2020;38;55,973541;12,534777;1946;2021;75
2020;40;55,522881;9,709432;2004;2021;17
2020;55;55,242371;10,53961;1866;2021;155
2020;64;54,689732;11,964726;1971;2021;50
2020;73;55,84433;9,589121;1848;2021;173
2020;77;56,028439;12,589834;1921;2021;100
2020;87;55,941434;12,268503;1937;2021;84
2020;88;55,944946;12,309925;1923;2021;98
2020;93;57,356497;9,936222;1890;2021;131
2020;94;55,659832;11,393806;2014;2021;7
2020;95;55,704063;11,690361;1963;2021;58
2020;121;55,9653067;9,094499;1993;2021;28
2020;122;56,148673;9,142385;1994;2021;27
2020;125;57,104458;9,125031;2017;2020;3
2020;127;55,752999;11,321096;2016;2021;5
2020;135;55,482156;9,451854;1949;2021;72
2020;144;55,673798;12,577517;1891;2021;130
2020;145;55,682456;12,569828;1877;2021;144
2020;147;55,682258;12,575122;2011;2021;10
2020;154;56,520745;8,460418;2007;2021;14
2020;156;56,546487;8,414392;1971;2021;50
2020;165;56,6472378;9,970264;1954;2021;67
2020;169;55,490971;9,972686;1986;2021;35
2020;178;56,892465;8,79075;2020;2021;1
2020;187;55,548046;10,108677;2005;2021;16
2020;194;55,92104;10,25164;1956;2021;65
2020;195;55,9775064;10,1756177;1890;2021;131
2020;197;55,991623;10,251408;2020;2021;1
2020;204;55,837896;11,551628;1991;2021;30
2020;217;56,06639;8,314841;1969;2021;52
2020;220;55,627599;12,082505;2019;2021;2
2020;230;56,178325;9,590822;1971;2021;50
2020;236;56,090396;9,758625;1892;2021;129
2020;239;56,572888;9,051158;1907;2021;114
2020;254;56,486889;8,584746;2018;2021;3
2020;256;55,070962;10,511664;1920;2021;101
2020;258;55,1225643;10,7284368;1989;2021;32
2020;262;56,193792;10,691846;1993;2021;28
2020;270;56,302138;10,477471;1894;2021;127
2020;273;54,898325;9,802925;1952;2021;69
2020;283;55,054318;8,950471;1960;2021;61
2020;285;55,1913926;9,066302;1984;2021;37
2020;294;55,471013;9,099652;1865;2021;156
2020;301;55,643464;9,651961;1889;2021;132
2020;302;55,715222;9,319221;1940;2021;81
2020;307;55,716877;9,585268;1943;2021;78
2020;314;56,377182;9,64424;1972;2021;49
2020;315;56,552152;9,40118;1868;2021;153
2020;316;56,441433;9,422904;1951;2021;70
2020;319;54,9870148;12,2867744;2017;2021;4
2020;320;55,132722;12,008426;2009;2021;12
2020;322;54,9748134;12,2737822;1866;2021;155
2020;324;54,924137;10,278204;1985;2021;36
2020;327;55,030253;9,419819;1993;2020;27
2020;328;54,873518;9,518945;1921;2021;100
2020;339;56,214752;10,27358;1970;2021;51
2020;342;56,1956788;10,2204946;1970;2021;51
2020;346;56,067076;10,134812;1866;2021;155
2020;13;55,18902;14,96054;1867;2021;154
2020;26;55,28979;8,68128;1970;2021;51
2020;29;56,328077;10,04661;1876;2021;145
2020;83;56,08339;8,98743;1972;2021;49
2020;130;55,67057;11,18151;1899;2021;122
2020;208;55,74166;11,41925;1865;2021;156
2020;210;56,40504;10,10971;2000;2021;21
2020;228;56,27438;9,3948;2019;2021;2
2020;245;55,35164;11,32714;1938;2021;83
2020;263;56,32492;10,69459;2002;2021;19
2020;299;55,77169;9,47224;1960;2021;61
2020;335;57,04003;10,01645;1982;2021;39
2021;17;57,277261;9,94587;1986;2021;35
2021;38;55,973541;12,534777;1946;2021;75
2021;40;55,522881;9,709432;2004;2021;17
2021;55;55,242371;10,53961;1866;2021;155
2021;64;54,689732;11,964726;1971;2021;50
2021;73;55,84433;9,589121;1848;2021;173
2021;77;56,028439;12,589834;1921;2021;100
2021;87;55,941434;12,268503;1937;2021;84
2021;88;55,944946;12,309925;1923;2021;98
2021;93;57,356497;9,936222;1890;2021;131
2021;94;55,659832;11,393806;2014;2021;7
2021;95;55,704063;11,690361;1963;2021;58
2021;121;55,9653067;9,094499;1993;2021;28
2021;122;56,148673;9,142385;1994;2021;27
2021;127;55,752999;11,321096;2016;2021;5
2021;135;55,482156;9,451854;1949;2021;72
2021;144;55,673798;12,577517;1891;2021;130
2021;145;55,682456;12,569828;1877;2021;144
2021;147;55,682258;12,575122;2011;2021;10
2021;154;56,520745;8,460418;2007;2021;14
2021;156;56,546487;8,414392;1971;2021;50
2021;165;56,6472378;9,970264;1954;2021;67
2021;169;55,490971;9,972686;1986;2021;35
2021;178;56,892465;8,79075;2020;2021;1
2021;187;55,548046;10,108677;2005;2021;16
2021;194;55,92104;10,25164;1956;2021;65
2021;195;55,9775064;10,1756177;1890;2021;131
2021;197;55,991623;10,251408;2020;2021;1
2021;204;55,837896;11,551628;1991;2021;30
2021;217;56,06639;8,314841;1969;2021;52
2021;220;55,627599;12,082505;2019;2021;2
2021;230;56,178325;9,590822;1971;2021;50
2021;236;56,090396;9,758625;1892;2021;129
2021;239;56,572888;9,051158;1907;2021;114
2021;247;55,393129;11,362551;2021;2021;0
2021;254;56,486889;8,584746;2018;2021;3
2021;256;55,070962;10,511664;1920;2021;101
2021;258;55,1225643;10,7284368;1989;2021;32
2021;262;56,193792;10,691846;1993;2021;28
2021;270;56,302138;10,477471;1894;2021;127
2021;273;54,898325;9,802925;1952;2021;69
2021;283;55,054318;8,950471;1960;2021;61
2021;285;55,1913926;9,066302;1984;2021;37
2021;294;55,471013;9,099652;1865;2021;156
2021;301;55,643464;9,651961;1889;2021;132
2021;302;55,715222;9,319221;1940;2021;81
2021;307;55,716877;9,585268;1943;2021;78
2021;314;56,377182;9,64424;1972;2021;49
2021;315;56,552152;9,40118;1868;2021;153
2021;316;56,441433;9,422904;1951;2021;70
2021;319;54,9870148;12,2867744;2017;2021;4
2021;320;55,132722;12,008426;2009;2021;12
2021;322;54,9748134;12,2737822;1866;2021;155
2021;324;54,924137;10,278204;1985;2021;36
2021;328;54,873518;9,518945;1921;2021;100
2021;339;56,214752;10,27358;1970;2021;51
2021;342;56,1956788;10,2204946;1970;2021;51
2021;346;56,067076;10,134812;1866;2021;155
2021;13;55,18902;14,96054;1867;2021;154
2021;26;55,28979;8,68128;1970;2021;51
2021;29;56,328077;10,04661;1876;2021;145
2021;83;56,08339;8,98743;1972;2021;49
2021;130;55,67057;11,18151;1899;2021;122
2021;208;55,74166;11,41925;1865;2021;156
2021;210;56,40504;10,10971;2000;2021;21
2021;228;56,27438;9,3948;2019;2021;2
2021;245;55,35164;11,32714;1938;2021;83
2021;263;56,32492;10,69459;2002;2021;19
2021;299;55,77169;9,47224;1960;2021;61
2021;335;57,04003;10,01645;1982;2021;39
